# FROM-URL	TO-URL
/de/docs/AJAX	/de/docs/Web/Guide/AJAX
/de/docs/AJAX/Getting_Started	/de/docs/AJAX/Einführung
/de/docs/AJAX:Getting_Started	/de/docs/AJAX/Einführung
/de/docs/Apps/Progressiv	/de/docs/Web/Progressive_web_apps
/de/docs/Apps/Progressiv/Introduction	/de/docs/Web/Progressive_web_apps/Introduction
/de/docs/Barrierefreiheit	/de/docs/Web/Barrierefreiheit
/de/docs/Barrierefreiheit/ARIA	/de/docs/Web/Barrierefreiheit/ARIA
/de/docs/Barrierefreiheit/ARIA/ARIA_Live_Regionen	/de/docs/Web/Barrierefreiheit/ARIA/ARIA_Live_Regionen
/de/docs/Barrierefreiheit/An_overview_of_accessible_web_applications_and_widgets	/de/docs/Web/Barrierefreiheit/An_overview_of_accessible_web_applications_and_widgets
/de/docs/Barrierefreiheit/Webentwicklung	/de/docs/Web/Barrierefreiheit/Webentwicklung
/de/docs/Bug-Entdecken_Leitfaden	/de/docs/Richtlinien_zum_Schreiben_eines_Bugreports
/de/docs/Building_an_Extension	/de/docs/Erweiterung_erstellen
/de/docs/CSS	/de/docs/Web/CSS
/de/docs/CSS/-moz-border-radius	/de/docs/Web/CSS/border-radius
/de/docs/CSS/-moz-border-radius-bottomleft	/de/docs/Web/CSS/border-bottom-left-radius
/de/docs/CSS/-moz-border-radius-bottomright	/de/docs/Web/CSS/border-bottom-right-radius
/de/docs/CSS/-moz-border-radius-topleft	/de/docs/Web/CSS/border-top-left-radius
/de/docs/CSS/-moz-border-radius-topright	/de/docs/Web/CSS/border-top-right-radius
/de/docs/CSS/-moz-box-shadow	/de/docs/Web/CSS/box-shadow
/de/docs/CSS/-moz-image-region	/de/docs/Web/CSS/-moz-image-region
/de/docs/CSS/-moz-user-input	/de/docs/Web/CSS/-moz-user-input
/de/docs/CSS/-moz-user-modify	/de/docs/Web/CSS/-moz-user-modify
/de/docs/CSS/-moz-user-select	/de/docs/Web/CSS/-moz-user-select
/de/docs/CSS/:empty	/de/docs/Web/CSS/:empty
/de/docs/CSS/:lang	/de/docs/Web/CSS/:lang
/de/docs/CSS/@import	/de/docs/Web/CSS/@import
/de/docs/CSS/Attributselektoren	/de/docs/Web/CSS/Attributselektoren
/de/docs/CSS/Border-bottom-width	/de/docs/Web/CSS/Border-bottom-width
/de/docs/CSS/Border-left-width	/de/docs/Web/CSS/Border-left-width
/de/docs/CSS/Border-right-width	/de/docs/Web/CSS/Border-right-width
/de/docs/CSS/Border-top-width	/de/docs/Web/CSS/Border-top-width
/de/docs/CSS/Bottom	/de/docs/Web/CSS/Bottom
/de/docs/CSS/Boxmodell	/de/docs/Web/CSS/CSS_Boxmodell/Einführung_in_das_CSS_Boxmodell
/de/docs/CSS/CSS_Reference/Property_Template	/de/docs/Web/CSS/Property_Template
/de/docs/CSS/CSS_Unterstützung	/de/docs/Web/CSS/CSS_Unterstützung
/de/docs/CSS/CSS_Werte_Geltung	/de/docs/Web/CSS
/de/docs/CSS/CSS_animated_properties	/de/docs/Web/CSS
/de/docs/CSS/CSS_animierbare_Eigenschaften	/de/docs/Web/CSS
/de/docs/CSS/CSS_prozentuale_werte	/de/docs/Web/CSS
/de/docs/CSS/CSS_werte_syntax	/de/docs/Web/CSS
/de/docs/CSS/Einführung	/de/docs/Web/Guide/CSS/Getting_started
/de/docs/CSS/Einheiten	/de/docs/Web/CSS/Einheiten
/de/docs/CSS/Farben	/de/docs/Web/CSS/Farben
/de/docs/CSS/Getting_Started	/de/docs/Web/Guide/CSS/Getting_started
/de/docs/CSS/Getting_Started-weiterleitung-1	/de/docs/Web/Guide/CSS/Getting_started
/de/docs/CSS/Initialwert	/de/docs/Web/CSS/Initialwert
/de/docs/CSS/Left	/de/docs/Web/CSS/Left
/de/docs/CSS/Right	/de/docs/Web/CSS/Right
/de/docs/CSS/Top	/de/docs/Web/CSS/Top
/de/docs/CSS/Vererbung	/de/docs/Web/CSS/Vererbung
/de/docs/CSS/Vorlage	/de/docs/Web/CSS/Property_Template
/de/docs/CSS/Wertdefinitionssyntax	/de/docs/Web/CSS/Wertdefinitionssyntax
/de/docs/CSS/azimuth	/de/docs/CSS/Refrerenz/Azimuth
/de/docs/CSS/background	/de/docs/Web/CSS/background
/de/docs/CSS/background-attachment	/de/docs/Web/CSS/background-attachment
/de/docs/CSS/background-clip	/de/docs/Web/CSS/background-clip
/de/docs/CSS/background-color	/de/docs/Web/CSS/background-color
/de/docs/CSS/background-image	/de/docs/Web/CSS/background-image
/de/docs/CSS/background-origin	/de/docs/Web/CSS/background-origin
/de/docs/CSS/background-position	/de/docs/Web/CSS/background-position
/de/docs/CSS/background-repeat	/de/docs/Web/CSS/background-repeat
/de/docs/CSS/background-size	/de/docs/Web/CSS/background-size
/de/docs/CSS/berechneter_Wert	/de/docs/Web/CSS/berechneter_Wert
/de/docs/CSS/border	/de/docs/Web/CSS/border
/de/docs/CSS/border-bottom	/de/docs/Web/CSS/border-bottom
/de/docs/CSS/border-bottom-color	/de/docs/Web/CSS/border-bottom-color
/de/docs/CSS/border-bottom-left-radius	/de/docs/Web/CSS/border-bottom-left-radius
/de/docs/CSS/border-bottom-right-radius	/de/docs/Web/CSS/border-bottom-right-radius
/de/docs/CSS/border-bottom-style	/de/docs/Web/CSS/border-bottom-style
/de/docs/CSS/border-collapse	/de/docs/Web/CSS/border-collapse
/de/docs/CSS/border-color	/de/docs/Web/CSS/border-color
/de/docs/CSS/border-left	/de/docs/Web/CSS/border-left
/de/docs/CSS/border-left-color	/de/docs/Web/CSS/border-left-color
/de/docs/CSS/border-left-style	/de/docs/Web/CSS/border-left-style
/de/docs/CSS/border-radius	/de/docs/Web/CSS/border-radius
/de/docs/CSS/border-right	/de/docs/Web/CSS/border-right
/de/docs/CSS/border-right-color	/de/docs/Web/CSS/border-right-color
/de/docs/CSS/border-right-style	/de/docs/Web/CSS/border-right-style
/de/docs/CSS/border-spacing	/de/docs/Web/CSS/border-spacing
/de/docs/CSS/border-style	/de/docs/Web/CSS/border-style
/de/docs/CSS/border-top	/de/docs/Web/CSS/border-top
/de/docs/CSS/border-top-color	/de/docs/Web/CSS/border-top-color
/de/docs/CSS/border-top-left-radius	/de/docs/Web/CSS/border-top-left-radius
/de/docs/CSS/border-top-right-radius	/de/docs/Web/CSS/border-top-right-radius
/de/docs/CSS/border-top-style	/de/docs/Web/CSS/border-top-style
/de/docs/CSS/border-width	/de/docs/Web/CSS/border-width
/de/docs/CSS/box-shadow	/de/docs/Web/CSS/box-shadow
/de/docs/CSS/box-sizing	/de/docs/Web/CSS/box-sizing
/de/docs/CSS/calc	/de/docs/Web/CSS/calc()
/de/docs/CSS/clear	/de/docs/Web/CSS/clear
/de/docs/CSS/color	/de/docs/Web/CSS/color
/de/docs/CSS/cursor	/de/docs/Web/CSS/cursor
/de/docs/CSS/display	/de/docs/Web/CSS/display
/de/docs/CSS/empty-cells	/de/docs/Web/CSS/empty-cells
/de/docs/CSS/float	/de/docs/Web/CSS/float
/de/docs/CSS/font	/de/docs/Web/CSS/font
/de/docs/CSS/height	/de/docs/Web/CSS/height
/de/docs/CSS/hyphens	/de/docs/Web/CSS/hyphens
/de/docs/CSS/laenge	/de/docs/Web/CSS/Einheiten
/de/docs/CSS/list-style	/de/docs/Web/CSS/list-style
/de/docs/CSS/margin	/de/docs/Web/CSS/margin
/de/docs/CSS/margin-bottom	/de/docs/Web/CSS/margin-bottom
/de/docs/CSS/margin-left	/de/docs/Web/CSS/margin-left
/de/docs/CSS/margin-right	/de/docs/Web/CSS/margin-right
/de/docs/CSS/margin-top	/de/docs/Web/CSS/margin-top
/de/docs/CSS/max-height	/de/docs/Web/CSS/max-height
/de/docs/CSS/max-width	/de/docs/Web/CSS/max-width
/de/docs/CSS/min-height	/de/docs/Web/CSS/min-height
/de/docs/CSS/min-width	/de/docs/Web/CSS/min-width
/de/docs/CSS/opacity	/de/docs/Web/CSS/opacity
/de/docs/CSS/overflow	/de/docs/Web/CSS/overflow
/de/docs/CSS/padding	/de/docs/Web/CSS/padding
/de/docs/CSS/padding-bottom	/de/docs/Web/CSS/padding-bottom
/de/docs/CSS/padding-left	/de/docs/Web/CSS/padding-left
/de/docs/CSS/padding-right	/de/docs/Web/CSS/padding-right
/de/docs/CSS/padding-top	/de/docs/Web/CSS/padding-top
/de/docs/CSS/page-break-after	/de/docs/Web/CSS/page-break-after
/de/docs/CSS/page-break-before	/de/docs/Web/CSS/page-break-before
/de/docs/CSS/page-break-inside	/de/docs/Web/CSS/page-break-inside
/de/docs/CSS/position	/de/docs/Web/CSS/position
/de/docs/CSS/resize	/de/docs/Web/CSS/resize
/de/docs/CSS/text-align	/de/docs/Web/CSS/text-align
/de/docs/CSS/text-decoration	/de/docs/Web/CSS/text-decoration
/de/docs/CSS/text-decoration-color	/de/docs/Web/CSS/text-decoration-color
/de/docs/CSS/text-shadow	/de/docs/Web/CSS/text-shadow
/de/docs/CSS/text-shadow/text-shadow	/en-US/docs/User:Elchi3/text-shadow
/de/docs/CSS/time	/de/docs/Web/CSS/time
/de/docs/CSS/vertical-align	/de/docs/Web/CSS/vertical-align
/de/docs/CSS/visibility	/de/docs/Web/CSS/visibility
/de/docs/CSS/width	/de/docs/Web/CSS/width
/de/docs/CSS/xx	/de/docs/Web/CSS/xx
/de/docs/CSS:-moz-border-radius	/de/docs/Web/CSS/border-radius
/de/docs/CSS:-moz-border-radius-bottomleft	/de/docs/Web/CSS/border-bottom-left-radius
/de/docs/CSS:-moz-border-radius-bottomright	/de/docs/Web/CSS/border-bottom-right-radius
/de/docs/CSS:-moz-border-radius-topleft	/de/docs/Web/CSS/border-top-left-radius
/de/docs/CSS:-moz-border-radius-topright	/de/docs/Web/CSS/border-top-right-radius
/de/docs/CSS:-moz-user-input	/de/docs/Web/CSS/-moz-user-input
/de/docs/CSS:-moz-user-modify	/de/docs/Web/CSS/-moz-user-modify
/de/docs/CSS:-moz-user-select	/de/docs/Web/CSS/-moz-user-select
/de/docs/CSS::empty	/de/docs/Web/CSS/:empty
/de/docs/CSS::lang	/de/docs/Web/CSS/:lang
/de/docs/CSS:@import	/de/docs/Web/CSS/@import
/de/docs/CSS:Boxmodell	/de/docs/Web/CSS/CSS_Boxmodell/Einführung_in_das_CSS_Boxmodell
/de/docs/CSS:Einheiten	/de/docs/Web/CSS/Einheiten
/de/docs/CSS:Farben	/de/docs/Web/CSS/Farben
/de/docs/CSS:Vorlage	/de/docs/Web/CSS/Property_Template
/de/docs/CSS:azimuth	/de/docs/CSS/Refrerenz/Azimuth
/de/docs/CSS:background	/de/docs/Web/CSS/background
/de/docs/CSS:background-attachment	/de/docs/Web/CSS/background-attachment
/de/docs/CSS:background-color	/de/docs/Web/CSS/background-color
/de/docs/CSS:background-image	/de/docs/Web/CSS/background-image
/de/docs/CSS:background-position	/de/docs/Web/CSS/background-position
/de/docs/CSS:background-repeat	/de/docs/Web/CSS/background-repeat
/de/docs/CSS:border	/de/docs/Web/CSS/border
/de/docs/CSS:border-bottom	/de/docs/Web/CSS/border-bottom
/de/docs/CSS:border-bottom-color	/de/docs/Web/CSS/border-bottom-color
/de/docs/CSS:border-bottom-style	/de/docs/Web/CSS/border-bottom-style
/de/docs/CSS:border-collapse	/de/docs/Web/CSS/border-collapse
/de/docs/CSS:border-color	/de/docs/Web/CSS/border-color
/de/docs/CSS:border-left	/de/docs/Web/CSS/border-left
/de/docs/CSS:border-left-color	/de/docs/Web/CSS/border-left-color
/de/docs/CSS:border-left-style	/de/docs/Web/CSS/border-left-style
/de/docs/CSS:border-right	/de/docs/Web/CSS/border-right
/de/docs/CSS:border-right-color	/de/docs/Web/CSS/border-right-color
/de/docs/CSS:border-right-style	/de/docs/Web/CSS/border-right-style
/de/docs/CSS:border-spacing	/de/docs/Web/CSS/border-spacing
/de/docs/CSS:border-style	/de/docs/Web/CSS/border-style
/de/docs/CSS:border-top	/de/docs/Web/CSS/border-top
/de/docs/CSS:border-top-color	/de/docs/Web/CSS/border-top-color
/de/docs/CSS:border-top-style	/de/docs/Web/CSS/border-top-style
/de/docs/CSS:border-width	/de/docs/Web/CSS/border-width
/de/docs/CSS:clear	/de/docs/Web/CSS/clear
/de/docs/CSS:color	/de/docs/Web/CSS/color
/de/docs/CSS:cue	/de/docs/CSS/cue
/de/docs/CSS:cue-after	/de/docs/CSS/cue-after
/de/docs/CSS:cue-before	/de/docs/CSS/cue-before
/de/docs/CSS:cursor	/de/docs/Web/CSS/cursor
/de/docs/CSS:display	/de/docs/Web/CSS/display
/de/docs/CSS:empty-cells	/de/docs/Web/CSS/empty-cells
/de/docs/CSS:float	/de/docs/Web/CSS/float
/de/docs/CSS:font	/de/docs/Web/CSS/font
/de/docs/CSS:height	/de/docs/Web/CSS/height
/de/docs/CSS:laenge	/de/docs/Web/CSS/Einheiten
/de/docs/CSS:list-style	/de/docs/Web/CSS/list-style
/de/docs/CSS:margin	/de/docs/Web/CSS/margin
/de/docs/CSS:margin-bottom	/de/docs/Web/CSS/margin-bottom
/de/docs/CSS:margin-left	/de/docs/Web/CSS/margin-left
/de/docs/CSS:margin-right	/de/docs/Web/CSS/margin-right
/de/docs/CSS:margin-top	/de/docs/Web/CSS/margin-top
/de/docs/CSS:max-height	/de/docs/Web/CSS/max-height
/de/docs/CSS:max-width	/de/docs/Web/CSS/max-width
/de/docs/CSS:min-height	/de/docs/Web/CSS/min-height
/de/docs/CSS:min-width	/de/docs/Web/CSS/min-width
/de/docs/CSS:opacity	/de/docs/Web/CSS/opacity
/de/docs/CSS:overflow	/de/docs/Web/CSS/overflow
/de/docs/CSS:padding	/de/docs/Web/CSS/padding
/de/docs/CSS:padding-bottom	/de/docs/Web/CSS/padding-bottom
/de/docs/CSS:padding-left	/de/docs/Web/CSS/padding-left
/de/docs/CSS:padding-right	/de/docs/Web/CSS/padding-right
/de/docs/CSS:padding-top	/de/docs/Web/CSS/padding-top
/de/docs/CSS:page-break-after	/de/docs/Web/CSS/page-break-after
/de/docs/CSS:page-break-before	/de/docs/Web/CSS/page-break-before
/de/docs/CSS:page-break-inside	/de/docs/Web/CSS/page-break-inside
/de/docs/CSS:pause	/de/docs/CSS/pause
/de/docs/CSS:pause-after	/de/docs/CSS/pause-after
/de/docs/CSS:pause-before	/de/docs/CSS/pause-before
/de/docs/CSS:play-during	/de/docs/CSS/play-during
/de/docs/CSS:position	/de/docs/Web/CSS/position
/de/docs/CSS:speak	/de/docs/CSS/speak
/de/docs/CSS:speak-header	/de/docs/CSS/speak-header
/de/docs/CSS:speak-numeral	/de/docs/CSS/speak-numeral
/de/docs/CSS:speak-punctuation	/de/docs/CSS/speak-punctuation
/de/docs/CSS:text-align	/de/docs/Web/CSS/text-align
/de/docs/CSS:text-decoration	/de/docs/Web/CSS/text-decoration
/de/docs/CSS:vertical-align	/de/docs/Web/CSS/vertical-align
/de/docs/CSS:visibility	/de/docs/Web/CSS/visibility
/de/docs/CSS:volume	/de/docs/CSS/volume
/de/docs/CSS:width	/de/docs/Web/CSS/width
/de/docs/CSS_Referenz	/de/docs/Web/CSS/CSS_Referenz
/de/docs/CSS_Referenz/Mozilla_CSS_Erweiterungen	/de/docs/Web/CSS/Mozilla_Extensions
/de/docs/CSS_in_HTML_einbinden	/de/docs/Web/CSS/@import
/de/docs/Code_snippets	/de/docs/Codeschnipsel
/de/docs/Code_snippets/Scrollbar	/de/docs/Codeschnipsel/Scrollbar
/de/docs/Code_snippets/Windows	/de/docs/Codeschnipsel/Windows
/de/docs/Code_snippets:Tree	/de/docs/Code_snippets/Tree
/de/docs/Creating_a_Skin_for_Firefox	/de/docs/Theme_erstellen
/de/docs/Creating_a_Skin_for_Firefox/contents.rdf	/de/docs/Theme_erstellen/contents.rdf
/de/docs/Creating_a_Skin_for_Firefox/install.rdf	/de/docs/Theme_erstellen/install.rdf
/de/docs/Creating_a_Skin_for_Firefox:contents.rdf	/de/docs/Theme_erstellen/contents.rdf
/de/docs/Creating_a_Skin_for_Firefox:install.rdf	/de/docs/Theme_erstellen/install.rdf
/de/docs/DOM/File.fileName	/de/docs/Web/API/File/fileName
/de/docs/DOM/File.fileSize	/de/docs/Web/API/File/fileSize
/de/docs/DOM/File.getAsText	/de/docs/Web/API/File/getAsText
/de/docs/DOM/File.lastModifiedDate	/de/docs/Web/API/File/lastModifiedDate
/de/docs/DOM/File.name	/de/docs/Web/API/File/name
/de/docs/DOM/File.size	/de/docs/Web/API/Blob/size
/de/docs/DOM/File.type	/de/docs/Web/API/File/type
/de/docs/DOM/Node	/de/docs/Web/API/Node
/de/docs/DOM/Node.childNodes	/de/docs/Web/API/Node/childNodes
/de/docs/DOM/Node.firstChild	/de/docs/Web/API/Node/firstChild
/de/docs/DOM/Node.lastChild	/de/docs/Web/API/Node/lastChild
/de/docs/DOM/Node.nextSibling	/de/docs/Web/API/Node/nextSibling
/de/docs/DOM/Node.parentNode	/de/docs/Web/API/Node/parentNode
/de/docs/DOM/Node.previousSibling	/de/docs/Web/API/Node/previousSibling
/de/docs/DOM/Node.replaceChild	/de/docs/Web/API/Node/replaceChild
/de/docs/DOM/Node.textContent	/de/docs/Web/API/Node/textContent
/de/docs/DOM/XMLHttpRequest	/de/docs/Web/API/XMLHttpRequest
/de/docs/DOM/document	/de/docs/Web/API/Document
/de/docs/DOM/document.createElement	/de/docs/Web/API/Document/createElement
/de/docs/DOM/element	/de/docs/Web/API/Element
/de/docs/DOM/navigator.id	/de/docs/Web/API/Navigator/id
/de/docs/DOM/window	/de/docs/Web/API/Window
/de/docs/DOM/window.dump	/de/docs/Web/API/Window/dump
/de/docs/DOM/window.openDialog	/de/docs/Web/API/Window/openDialog
/de/docs/DOM/window.setTimeout	/de/docs/Web/API/WindowTimers/setTimeout
/de/docs/Developer_Guide	/de/docs/Mozilla/Developer_guide
/de/docs/Developer_Guide/firefox_erfolgreich_erstellt	/de/docs/Mozilla/Developer_guide/firefox_erfolgreich_erstellt
/de/docs/Eine_erste_Erweiterung_erstellen	/de/docs/Erweiterung_erstellen
/de/docs/Einfacher_Thunderbird_build	/de/docs/Mozilla/Developer_guide/Build_Anweisungen/Einfacher_Thunderbird_build
/de/docs/Einführung_in_den_Gebrauch_von_XPath_in_JavaScript	/de/docs/Web/JavaScript/Einführung_in_den_Gebrauch_von_XPath_in_JavaScript
/de/docs/Einleitung	/de/docs/Mozilla/Developer_guide/Einleitung
/de/docs/Entwicklerhandbuch	/de/docs/Mozilla/Developer_guide
/de/docs/Entwicklerhandbuch/Build_Anweisungen	/de/docs/Mozilla/Developer_guide/Build_Anweisungen
/de/docs/Entwicklerhandbuch/Build_Anweisungen/TOC	/de/docs/Mozilla/Developer_guide/Build_Anweisungen/TOC
/de/docs/Entwicklerhandbuch/Build_Anweisungen/Windows_Build_Voraussetzungen	/de/docs/Mozilla/Developer_guide/Build_Anweisungen/Windows_Build_Voraussetzungen
/de/docs/Entwicklerhandbuch/Quelltexte	/de/docs/Mozilla/Developer_guide/Quelltexte
/de/docs/Entwicklerhandbuch/Quelltexte/Mozilla_Quelltexte_herunterladen	/de/docs/Mozilla/Developer_guide/Quelltexte/Mozilla_Quelltexte_herunterladen
/de/docs/Entwicklerhandbuch/Quelltexte/Verzeichnis_struktur	/de/docs/Mozilla/Developer_guide/Quelltexte/Verzeichnis_struktur
/de/docs/Error_Console	/de/docs/Fehlerkonsole
/de/docs/Firefox_1.5_Beta	/de/docs/Firefox_1.5_für_Entwickler
/de/docs/HTML	/de/docs/Web/HTML
/de/docs/HTML/Block-level_elemente	/de/docs/Web/HTML/Block-level_elemente
/de/docs/HTML/Element	/de/docs/Web/HTML/Element
/de/docs/HTML/Element/Input	/de/docs/Web/HTML/Element/Input
/de/docs/HTML/Element/b	/de/docs/Web/HTML/Element/b
/de/docs/HTML/Element/br	/de/docs/Web/HTML/Element/br
/de/docs/HTML/Element/canvas	/de/docs/Web/HTML/Element/canvas
/de/docs/HTML/Element/datalist	/de/docs/Web/HTML/Element/datalist
/de/docs/HTML/Element/h1	/de/docs/Web/HTML/Element/h1-h6
/de/docs/HTML/Element/h1-h6	/de/docs/Web/HTML/Element/h1-h6
/de/docs/HTML/Element/h2	/de/docs/Web/HTML/Element/h1-h6
/de/docs/HTML/Element/h3	/de/docs/Web/HTML/Element/h1-h6
/de/docs/HTML/Element/h4	/de/docs/Web/HTML/Element/h1-h6
/de/docs/HTML/Element/h5	/de/docs/Web/HTML/Element/h1-h6
/de/docs/HTML/Element/h6	/de/docs/Web/HTML/Element/h1-h6
/de/docs/HTML/Element/head	/de/docs/Web/HTML/Element/head
/de/docs/HTML/Element/hr	/de/docs/Web/HTML/Element/hr
/de/docs/HTML/Element/html	/de/docs/Web/HTML/Element/html
/de/docs/HTML/Element/iframe	/de/docs/Web/HTML/Element/iframe
/de/docs/HTML/Element/li	/de/docs/Web/HTML/Element/li
/de/docs/HTML/Element/noscript	/de/docs/Web/HTML/Element/noscript
/de/docs/HTML/Element/ol	/de/docs/Web/HTML/Element/ol
/de/docs/HTML/Element/p	/de/docs/Web/HTML/Element/p
/de/docs/HTML/Element/pre	/de/docs/Web/HTML/Element/pre
/de/docs/HTML/Element/strong	/de/docs/Web/HTML/Element/strong
/de/docs/HTML/Element/time	/de/docs/Web/HTML/Element/time
/de/docs/HTML/Element/ul	/de/docs/Web/HTML/Element/ul
/de/docs/HTML/Element/var	/de/docs/Web/HTML/Element/var
/de/docs/HTML/HTML5	/de/docs/Web/HTML/HTML5
/de/docs/HTML/HTML5/HTML5_element_list	/de/docs/Web/HTML/HTML5/HTML5_element_list
/de/docs/HTML/HTML5/liste_der_HTML5_elemente	/de/docs/Web/HTML/HTML5/HTML5_element_list
/de/docs/HTML/HTML_Lernen_für_Anfänger	/de/docs/HTML/HTML_beginner
/de/docs/HTML/Inline_elemente	/de/docs/Web/HTML/Inline_elemente
/de/docs/HTML/Using_HTML5_audio_and_video	/de/docs/Web/HTML/Using_HTML5_audio_and_video
/de/docs/HTML/Using_the_application_cache	/de/docs/Web/HTML/Using_the_application_cache
/de/docs/HTML:Beispiele	/de/docs/HTML/Beispiele
/de/docs/HTML:Element	/de/docs/Web/HTML/Element
/de/docs/HTML:Element:b	/de/docs/Web/HTML/Element/b
/de/docs/HTML:Element:h1	/de/docs/Web/HTML/Element/h1-h6
/de/docs/HTML:Element:h2	/de/docs/Web/HTML/Element/h1-h6
/de/docs/HTML:Element:h3	/de/docs/Web/HTML/Element/h1-h6
/de/docs/HTML:Element:h4	/de/docs/Web/HTML/Element/h1-h6
/de/docs/HTML:Element:h5	/de/docs/Web/HTML/Element/h1-h6
/de/docs/HTML:Element:h6	/de/docs/Web/HTML/Element/h1-h6
/de/docs/HTML:Element:head	/de/docs/Web/HTML/Element/head
/de/docs/HTML:Element:hr	/de/docs/Web/HTML/Element/hr
/de/docs/HTML:Element:html	/de/docs/Web/HTML/Element/html
/de/docs/HTML:Element:iframe	/de/docs/Web/HTML/Element/iframe
/de/docs/HTML:Element:li	/de/docs/Web/HTML/Element/li
/de/docs/HTML:Element:ol	/de/docs/Web/HTML/Element/ol
/de/docs/HTML:Element:p	/de/docs/Web/HTML/Element/p
/de/docs/HTML:Element:strong	/de/docs/Web/HTML/Element/strong
/de/docs/HTML:Element:ul	/de/docs/Web/HTML/Element/ul
/de/docs/HTML:Element:var	/de/docs/Web/HTML/Element/var
/de/docs/HTTP_Request_Header_setzen	/de/docs/XPCOM/HTTP_Request_Header_setzen
/de/docs/Hauptseite	/de/docs/Web
/de/docs/IndexedDB	/de/docs/Web/API/IndexedDB_API
/de/docs/IndexedDB/Browser_storage_limits_and_eviction_criteria	/de/docs/Web/API/IndexedDB_API/Browser_storage_limits_and_eviction_criteria
/de/docs/IndexedDB/Grundkonzepte_hinter_IndexedDB	/de/docs/Web/API/IndexedDB_API/Grundkonzepte_hinter_IndexedDB
/de/docs/IndexedDB/IndexedDB_verwenden	/de/docs/Web/API/IndexedDB_API/IndexedDB_verwenden
/de/docs/JavaScript	/de/docs/Web/JavaScript
/de/docs/JavaScript/Eine_Wiedereinfuehrung_in_JavaScript	/de/docs/Web/JavaScript/Eine_Wiedereinfuehrung_in_JavaScript
/de/docs/JavaScript/Guide	/de/docs/Web/JavaScript/Guide
/de/docs/JavaScript/Guide/Ausdruecke_und_Operatoren	/de/docs/Web/JavaScript/Guide/Ausdruecke_und_Operatoren
/de/docs/JavaScript/Guide/Closures	/de/docs/Web/JavaScript/Closures
/de/docs/JavaScript/Guide/Feinheiten_des_Objektmodells	/de/docs/Web/JavaScript/Guide/Feinheiten_des_Objektmodells
/de/docs/JavaScript/Guide/Funktionen	/de/docs/Web/JavaScript/Guide/Funktionen
/de/docs/JavaScript/Guide/Iteratoren_und_Generatoren	/de/docs/Web/JavaScript/Guide/Iteratoren_und_Generatoren
/de/docs/JavaScript/Guide/Mit_Objekten_arbeiten	/de/docs/Web/JavaScript/Guide/Mit_Objekten_arbeiten
/de/docs/JavaScript/Guide/Regular_Expressions	/de/docs/Web/JavaScript/Guide/Regular_Expressions
/de/docs/JavaScript/Guide/Statements	/de/docs/Web/JavaScript/Guide/Kontrollfluss_und_Fehlerbehandlung
/de/docs/JavaScript/Guide/Ueber_JavaScript	/de/docs/Web/JavaScript/Guide/Einführung
/de/docs/JavaScript/Guide/Ueber_diese_Einfuehrung	/de/docs/Web/JavaScript/Guide/Einführung
/de/docs/JavaScript/Guide/Vererbung_ueberdacht	/de/docs/Web/JavaScript/Inheritance_and_the_prototype_chain
/de/docs/JavaScript/Guide/Vordefinierte_Kernobjekte	/de/docs/Web/JavaScript/Guide
/de/docs/JavaScript/Guide/Werte_Variablen_und_Literale	/de/docs/Web/JavaScript/Guide/Grammatik_und_Typen
/de/docs/JavaScript/Guide/Über_Javascript	/de/docs/Web/JavaScript/Guide/Einführung
/de/docs/JavaScript/Guide/Über_diese_Einführung	/de/docs/Web/JavaScript/Guide/Einführung
/de/docs/JavaScript/JQuery	/de/docs/Web/JavaScript/JQuery
/de/docs/JavaScript/Javascript_lernen_für_Anfänger	/de/docs/Web/JavaScript/Guide
/de/docs/JavaScript/Language_Resources	/de/docs/Web/JavaScript/Language_Resources
/de/docs/JavaScript/Neu_in_JavaScript	/de/docs/Web/JavaScript/Neu_in_JavaScript
/de/docs/JavaScript/Neu_in_JavaScript/1.5	/de/docs/Web/JavaScript/Neu_in_JavaScript/1.5
/de/docs/JavaScript/Neu_in_JavaScript/1.6	/de/docs/Web/JavaScript/Neu_in_JavaScript/1.6
/de/docs/JavaScript/Neu_in_JavaScript/1.7	/de/docs/Web/JavaScript/Neu_in_JavaScript/1.7
/de/docs/JavaScript/Neu_in_JavaScript/1.8	/de/docs/Web/JavaScript/Neu_in_JavaScript/1.8
/de/docs/JavaScript/Neu_in_JavaScript/1.8.1	/de/docs/Web/JavaScript/Neu_in_JavaScript/1.8.1
/de/docs/JavaScript/Neu_in_JavaScript/1.8.5	/de/docs/Web/JavaScript/Neu_in_JavaScript/1.8.5
/de/docs/JavaScript/Reference	/de/docs/Web/JavaScript/Reference
/de/docs/JavaScript/Reference/Global_Objects	/de/docs/Web/JavaScript/Reference/Global_Objects
/de/docs/JavaScript/Reference/Global_Objects/Array	/de/docs/Web/JavaScript/Reference/Global_Objects/Array
/de/docs/JavaScript/Reference/Global_Objects/Array/isArray	/de/docs/Web/JavaScript/Reference/Global_Objects/Array/isArray
/de/docs/JavaScript/Reference/Global_Objects/Array/pop	/de/docs/Web/JavaScript/Reference/Global_Objects/Array/pop
/de/docs/JavaScript/Reference/Global_Objects/Array/push	/de/docs/Web/JavaScript/Reference/Global_Objects/Array/push
/de/docs/JavaScript/Reference/Global_Objects/Array/reverse	/de/docs/Web/JavaScript/Reference/Global_Objects/Array/reverse
/de/docs/JavaScript/Reference/Global_Objects/Array/shift	/de/docs/Web/JavaScript/Reference/Global_Objects/Array/shift
/de/docs/JavaScript/Reference/Global_Objects/Date	/de/docs/Web/JavaScript/Reference/Global_Objects/Date
/de/docs/JavaScript/Reference/Global_Objects/Date/now	/de/docs/Web/JavaScript/Reference/Global_Objects/Date/now
/de/docs/JavaScript/Reference/Global_Objects/NaN	/de/docs/Web/JavaScript/Reference/Global_Objects/NaN
/de/docs/JavaScript/Reference/Global_Objects/Number	/de/docs/Web/JavaScript/Reference/Global_Objects/Number
/de/docs/JavaScript/Reference/Global_Objects/Number/EPSILON	/de/docs/Web/JavaScript/Reference/Global_Objects/Number/EPSILON
/de/docs/JavaScript/Reference/Global_Objects/Object	/de/docs/Web/JavaScript/Reference/Global_Objects/Object
/de/docs/JavaScript/Reference/Global_Objects/Object/constructor	/de/docs/Web/JavaScript/Reference/Global_Objects/Object/constructor
/de/docs/JavaScript/Reference/Global_Objects/Object/is	/de/docs/Web/JavaScript/Reference/Global_Objects/Object/is
/de/docs/JavaScript/Reference/Global_Objects/Object/propertyIsEnumerable	/de/docs/Web/JavaScript/Reference/Global_Objects/Object/propertyIsEnumerable
/de/docs/JavaScript/Reference/Global_Objects/RegExp	/de/docs/Web/JavaScript/Reference/Global_Objects/RegExp
/de/docs/JavaScript/Reference/Global_Objects/String	/de/docs/Web/JavaScript/Reference/Global_Objects/String
/de/docs/JavaScript/Reference/Global_Objects/String/replace	/de/docs/Web/JavaScript/Reference/Global_Objects/String/replace
/de/docs/JavaScript/Speicherverwaltung	/de/docs/Web/JavaScript/Speicherverwaltung
/de/docs/JavaScript/java_guide	/de/docs/Web/JavaScript/Guide
/de/docs/JavaScript/javascript_guide	/de/docs/Web/JavaScript/Guide
/de/docs/JavaScript/javascript_guide/Anweisungen	/de/docs/Web/JavaScript/Guide/Kontrollfluss_und_Fehlerbehandlung
/de/docs/JavaScript/javascript_guide/Ausdrücke_und_Operatoren	/de/docs/Web/JavaScript/Guide/Ausdruecke_und_Operatoren
/de/docs/JavaScript/javascript_guide/Funktionen	/de/docs/Web/JavaScript/Guide/Funktionen
/de/docs/JavaScript/javascript_guide/Javascript_Übersicht	/de/docs/Web/JavaScript/Guide/Einführung
/de/docs/JavaScript/javascript_guide/Mit_Objekten_arbeiten	/de/docs/Web/JavaScript/Guide/Mit_Objekten_arbeiten
/de/docs/JavaScript/javascript_guide/Reguläre_Ausdrücke	/de/docs/Web/JavaScript/Guide/Regular_Expressions
/de/docs/JavaScript/javascript_guide/Werte,_Variable_und_Literale	/de/docs/Web/JavaScript/Guide/Grammatik_und_Typen
/de/docs/JavaScript/javascript_guide/Werte,_Variablen_und_Literale	/de/docs/Web/JavaScript/Guide/Grammatik_und_Typen
/de/docs/JavaScript/javascript_guide/ueber_javascript	/de/docs/Web/JavaScript/Guide/Einführung
/de/docs/JavaScript/javascript_guide/ueber_javascript/Über_Javascript	/de/docs/Web/JavaScript/Guide/Einführung
/de/docs/JavaScript/javascript_guide/Über_Javascript	/de/docs/Web/JavaScript/Guide/Einführung
/de/docs/JavaScript/javascript_guide/Über_diese_Einführung	/de/docs/Web/JavaScript/Guide/Einführung
/de/docs/JavaScript/ueber_JavaScript	/de/docs/Web/JavaScript/Guide/Einführung
/de/docs/JavaScript/ueber_JavaScript/Über_Javascript	/de/docs/Web/JavaScript/Guide/Einführung
/de/docs/JavaScript/Über_Javascript	/de/docs/Web/JavaScript/Guide/Einführung
/de/docs/Learn/CSS/Introduction_to_CSS	/en-US/docs/Learn/CSS/First_steps
/de/docs/Learn/CSS/Introduction_to_CSS/Attribute_selectors	/en-US/docs/Learn/CSS/Building_blocks/Selectors/Attribute_selectors
/de/docs/Learn/CSS/Introduction_to_CSS/Cascade_and_inheritance	/en-US/docs/Learn/CSS/Building_blocks/Cascade_and_inheritance
/de/docs/Learn/CSS/Introduction_to_CSS/Combinators_and_multiple_selectors	/en-US/docs/Learn/CSS/Building_blocks/Selectors/Combinators
/de/docs/Learn/CSS/Introduction_to_CSS/How_CSS_works	/en-US/docs/Learn/CSS/First_steps/How_CSS_works
/de/docs/Learn/CSS/Introduction_to_CSS/Pseudo-classes_and_pseudo-elements	/en-US/docs/Learn/CSS/Building_blocks/Selectors/Pseudo-classes_and_pseudo-elements
/de/docs/Learn/CSS/Introduction_to_CSS/Simple_selectors	/en-US/docs/Learn/CSS/Building_blocks/Selectors/Type_Class_and_ID_Selectors
/de/docs/Learn/CSS/Introduction_to_CSS/Syntax	/en-US/docs/Learn/CSS/First_steps/How_CSS_is_structured
/de/docs/Learn/CSS/Introduction_to_CSS/Values_and_units	/en-US/docs/Learn/CSS/Building_blocks/Values_and_units
/de/docs/Learn/CSS/Styling_boxes	/en-US/docs/Learn/CSS/Building_blocks
/de/docs/MDC_style_guide/MDC_style_guide	/en-US/docs/Project:En/MDC_style_guide
/de/docs/MDN/Contribute/Content	/de/docs/MDN/Guidelines
/de/docs/MDN/Contribute/Content/Style_guide	/de/docs/MDN/Guidelines/Style_guide
/de/docs/MDN/Contribute/Guidelines	/de/docs/MDN/Guidelines
/de/docs/MDN/Contribute/Guidelines/Style_guide	/de/docs/MDN/Guidelines/Style_guide
/de/docs/MDN/Contribute/Structures	/de/docs/MDN/Structures
/de/docs/MDN/Contribute/Structures/Kompatibilitaets_Tabellen	/de/docs/MDN/Structures/Kompatibilitaets_Tabellen
/de/docs/MDN/Erste_Schritte	/de/docs/MDN/Contribute/Getting_started
/de/docs/MDN/Feedback	/de/docs/MDN/Contribute/Feedback
/de/docs/MindTouch_Deki_bug_priorities	/en-US/docs/User:Sheppy/MindTouch_Deki_bug_priorities
/de/docs/Mozilla_Quelltexte_herunterladen	/de/docs/Mozilla/Developer_guide/Quelltexte/Mozilla_Quelltexte_herunterladen
/de/docs/Mozilla_entwickeln	/de/docs/Mozilla/Developer_guide
/de/docs/Neuste_Version	/de/docs/Mozilla/Developer_guide/Quelltexte/Mozilla_Quelltexte_herunterladen
/de/docs/Online_and_offline_events	/de/docs/Web/API/NavigatorOnLine/Online_and_offline_events
/de/docs/Profilmanager	/de/docs/Profile_Manager
/de/docs/QA/Stress_Testing	/de/docs/Qualitätssicherung/Stress_Testing
/de/docs/QA:Stress_Testing	/de/docs/Qualitätssicherung/Stress_Testing
/de/docs/SVG	/de/docs/Web/SVG
/de/docs/SVG/Element	/de/docs/Web/SVG/Element
/de/docs/SVG/Element/animate	/de/docs/Web/SVG/Element/animate
/de/docs/SVG/Element/foreignObject	/de/docs/Web/SVG/Element/foreignObject
/de/docs/SVG/Element/image	/de/docs/Web/SVG/Element/image
/de/docs/SVG/Tutorial	/de/docs/Web/SVG/Tutorial
/de/docs/SVG/Tutorial/Einführung	/de/docs/Web/SVG/Tutorial/Einführung
/de/docs/SVG_In_HTML_Introduction	/de/docs/Web/SVG/Tutorial/SVG_In_HTML_Introduction
/de/docs/SeaMonkey_mit_VC8_Express_Kompilieren	/de/docs/Mozilla/Developer_guide/Build_Anweisungen/Windows_Build_Voraussetzungen
/de/docs/SeaMonkey_mit_VC_8_Express_Kompilieren	/de/docs/Mozilla/Developer_guide/Build_Anweisungen/Windows_Build_Voraussetzungen
/de/docs/Simple_Firefox_build	/de/docs/Mozilla/Developer_guide/Build_Anweisungen/Simple_Firefox_build
/de/docs/Simple_Firefox_build/Linux_and_MacOS_build_preparation	/de/docs/Mozilla/Developer_guide/Build_Anweisungen/Simple_Firefox_build/Linux_and_MacOS_build_preparation
/de/docs/Suche_Plugins	/de/docs/OpenSearch_Plugin_für_Firefox_erstellen
/de/docs/Theme_erstellen:Einführung	/de/docs/Theme_erstellen/Einführung
/de/docs/Theme_erstellen:UUID	/de/docs/Theme_erstellen/UUID
/de/docs/Theme_erstellen:contents.rdf	/de/docs/Theme_erstellen/contents.rdf
/de/docs/Theme_erstellen:install.rdf	/de/docs/Theme_erstellen/install.rdf
/de/docs/Themen	/de/docs/Themes
/de/docs/Tools/Seiten_Inspektor/Style_panel	/de/docs/Tools/Seiten_Inspektor
/de/docs/Verwenden_des_Cache_beim_Firefox_1.5	/de/docs/Benutzen_des_Zwischenspeichers_in_Firefox_1.5_(caching)
/de/docs/Web/API/CSSRule.cssText	/de/docs/Web/API/CSSRule/cssText
/de/docs/Web/API/Element.querySelector	/de/docs/Web/API/Element/querySelector
/de/docs/Web/API/File/size	/de/docs/Web/API/Blob/size
/de/docs/Web/API/MozMobileConnection.selectNetworkAutomatically	/de/docs/Web/API/MozMobileConnection/selectNetworkAutomatically
/de/docs/Web/API/Node.cloneNode	/de/docs/Web/API/Node/cloneNode
/de/docs/Web/API/WebGL_API/3D-Objekte_mit_WebGL_erstellen	/de/docs/Web/API/WebGL_API/Tutorial/3D-Objekte_mit_WebGL_erstellen
/de/docs/Web/API/WebGL_API/Animierte_Texturen_in_WebGL	/de/docs/Web/API/WebGL_API/Tutorial/Animierte_Texturen_in_WebGL
/de/docs/Web/API/WebGL_API/Beleuchtung_in_WebGL	/de/docs/Web/API/WebGL_API/Tutorial/Beleuchtung_in_WebGL
/de/docs/Web/API/WebGL_API/Einführung_in_WebGL	/de/docs/Web/API/WebGL_API/Tutorial/Einführung_in_WebGL
/de/docs/Web/API/WebGL_API/Farben_mittels_Shader_in_einen_WebGL-Kontext_hinzufügen	/de/docs/Web/API/WebGL_API/Tutorial/Farben_mittels_Shader_in_einen_WebGL-Kontext_hinzufügen
/de/docs/Web/API/WebGL_API/Hinzufügen_von_2D_Inhalten_in_einen_WebGL-Kontext	/de/docs/Web/API/WebGL_API/Tutorial/Hinzufügen_von_2D_Inhalten_in_einen_WebGL-Kontext
/de/docs/Web/API/WebGL_API/Objekte_mit_WebGL_animieren	/de/docs/Web/API/WebGL_API/Tutorial/Objekte_mit_WebGL_animieren
/de/docs/Web/API/WebGL_API/Texturen_in_WebGL_verwenden	/de/docs/Web/API/WebGL_API/Tutorial/Texturen_in_WebGL_verwenden
/de/docs/Web/API/Window.alert	/de/docs/Web/API/Window/alert
/de/docs/Web/API/Window/setTimeout	/de/docs/Web/API/WindowTimers/setTimeout
/de/docs/Web/API/document.documentElement	/de/docs/Web/API/Document/documentElement
/de/docs/Web/CSS/-moz-alias	/de/docs/Web/CSS/cursor
/de/docs/Web/CSS/-moz-appearance	/de/docs/Web/CSS/appearance
/de/docs/Web/CSS/-moz-background-inline-policy	/de/docs/Web/CSS/box-decoration-break
/de/docs/Web/CSS/-moz-border-radius	/de/docs/Web/CSS/border-radius
/de/docs/Web/CSS/-moz-border-radius-bottomleft	/de/docs/Web/CSS/border-bottom-left-radius
/de/docs/Web/CSS/-moz-border-radius-bottomright	/de/docs/Web/CSS/border-bottom-right-radius
/de/docs/Web/CSS/-moz-border-radius-topleft	/de/docs/Web/CSS/border-top-left-radius
/de/docs/Web/CSS/-moz-border-radius-topright	/de/docs/Web/CSS/border-top-right-radius
/de/docs/Web/CSS/-moz-box-shadow	/de/docs/Web/CSS/box-shadow
/de/docs/Web/CSS/-moz-context-menu	/de/docs/Web/CSS/cursor
/de/docs/Web/CSS/-moz-copy	/de/docs/Web/CSS/cursor
/de/docs/Web/CSS/-moz-spinning	/de/docs/Web/CSS/cursor
/de/docs/Web/CSS/-webkit-mask-position	/de/docs/Web/CSS/mask-position
/de/docs/Web/CSS/Adjacent_sibling_combinator	/de/docs/Web/CSS/Angrenzende_Geschwisterselektoren
/de/docs/Web/CSS/Adjacent_sibling_selectors	/de/docs/Web/CSS/Angrenzende_Geschwisterselektoren
/de/docs/Web/CSS/Boxmodell	/de/docs/Web/CSS/CSS_Boxmodell/Einführung_in_das_CSS_Boxmodell
/de/docs/Web/CSS/CSS_Box_Model	/de/docs/Web/CSS/CSS_Boxmodell
/de/docs/Web/CSS/CSS_Box_Model/Box-shadow_generator	/de/docs/Web/CSS/CSS_Boxmodell/Box-shadow_generator
/de/docs/Web/CSS/CSS_Referenz/::backdrop	/de/docs/Web/CSS/::backdrop
/de/docs/Web/CSS/CSS_Referenz/<basic-shape>	/de/docs/Web/CSS/basic-shape
/de/docs/Web/CSS/CSS_Referenz/@viewport	/de/docs/Web/CSS/@viewport
/de/docs/Web/CSS/CSS_Referenz/Mozilla_CSS_Erweiterungen	/de/docs/Web/CSS/Mozilla_Extensions
/de/docs/Web/CSS/CSS_Referenz/Webkit_Extensions	/de/docs/Web/CSS/WebKit_Extensions
/de/docs/Web/CSS/CSS_Referenz/line-break	/de/docs/Web/CSS/line-break
/de/docs/Web/CSS/CSS_Referenz/mix-blend-mode	/de/docs/Web/CSS/mix-blend-mode
/de/docs/Web/CSS/CSS_Werte_Geltung	/de/docs/Web/CSS
/de/docs/Web/CSS/CSS_animierbare_Eigenschaften	/de/docs/Web/CSS
/de/docs/Web/CSS/CSS_prozentuale_werte	/de/docs/Web/CSS
/de/docs/Web/CSS/CSS_werte_syntax	/de/docs/Web/CSS
/de/docs/Web/CSS/Child_selectors	/de/docs/Web/CSS/Kindselektoren
/de/docs/Web/CSS/Getting_Started	/de/docs/Web/Guide/CSS/Getting_started
/de/docs/Web/CSS/Pseudoklasse	/de/docs/Web/CSS/Pseudo-classes
/de/docs/Web/CSS/Referenz	/de/docs/Web/CSS/CSS_Referenz
/de/docs/Web/CSS/Replaced_element	/de/docs/Web/CSS/ersetztes_Element
/de/docs/Web/CSS/attr	/de/docs/Web/CSS/attr()
/de/docs/Web/CSS/azimuth	/de/docs/CSS/Refrerenz/Azimuth
/de/docs/Web/CSS/calc	/de/docs/Web/CSS/calc()
/de/docs/Web/CSS/hidden	/de/docs/Web/CSS/visibility
/de/docs/Web/CSS/laenge	/de/docs/Web/CSS/Einheiten
/de/docs/Web/CSS/linear-gradient	/de/docs/Web/CSS/linear-gradient()
/de/docs/Web/CSS/marks	/de/docs/Web/CSS/@page/marks
/de/docs/Web/CSS/mq-boolean	/de/docs/Web/CSS/Media_Queries/Using_media_queries
/de/docs/Web/CSS/text-shadow/text-shadow	/en-US/docs/User:Elchi3/text-shadow
/de/docs/Web/CSS/visible	/de/docs/Web/CSS/visibility
/de/docs/Web/Events/fullscreenchange	/de/docs/Web/API/Document/fullscreenchange_event
/de/docs/Web/Events/popstate	/de/docs/Web/API/Window/popstate_event
/de/docs/Web/Events/submit	/de/docs/Web/API/HTMLFormElement/submit_event
/de/docs/Web/Events/touchstart	/de/docs/Web/API/Element/touchstart_event
/de/docs/Web/Events/webglcontextcreationerror	/de/docs/Web/API/HTMLCanvasElement/webglcontextcreationerror_event
/de/docs/Web/Events/webglcontextlost	/de/docs/Web/API/HTMLCanvasElement/webglcontextlost_event
/de/docs/Web/Events/webglcontextrestored	/de/docs/Web/API/HTMLCanvasElement/webglcontextrestored_event
/de/docs/Web/Guide/AJAX/Getting_Started	/de/docs/AJAX/Einführung
/de/docs/Web/Guide/CSS	/de/docs/Learn/CSS
/de/docs/Web/Guide/CSS/CSS_Animationen_nutzen	/de/docs/Web/CSS/CSS_Animations/CSS_Animationen_nutzen
/de/docs/Web/Guide/CSS/Flexible_boxes	/de/docs/Web/CSS/CSS_Flexible_Box_Layout/Using_CSS_flexible_boxes
/de/docs/Web/Guide/CSS/mehrere_Hintergründe_verwenden	/de/docs/Web/CSS/CSS_Background_and_Borders/Mehrere_Hintergründe_in_CSS_verwenden
/de/docs/Web/Guide/HTML	/de/docs/Learn/HTML
/de/docs/Web/Guide/HTML/Einführung	/de/docs/Learn/HTML/Einführung_in_HTML
/de/docs/Web/HTML/Element/Schaltfläche	/de/docs/Web/HTML/Element/button
/de/docs/Web/HTML/Element/h1	/de/docs/Web/HTML/Element/h1-h6
/de/docs/Web/HTML/Element/h2	/de/docs/Web/HTML/Element/h1-h6
/de/docs/Web/HTML/Element/h3	/de/docs/Web/HTML/Element/h1-h6
/de/docs/Web/HTML/Element/h4	/de/docs/Web/HTML/Element/h1-h6
/de/docs/Web/HTML/Element/h5	/de/docs/Web/HTML/Element/h1-h6
/de/docs/Web/HTML/Element/h6	/de/docs/Web/HTML/Element/h1-h6
/de/docs/Web/HTML/HTML_Lernen_für_Anfänger	/de/docs/HTML/HTML_beginner
/de/docs/Web/JavaScript/Datenstruktures	/de/docs/Web/JavaScript/Datenstrukturen
/de/docs/Web/JavaScript/Getting_Started	/de/docs/Learn/Getting_started_with_the_web/JavaScript_basics
/de/docs/Web/JavaScript/Guide/Closures	/de/docs/Web/JavaScript/Closures
/de/docs/Web/JavaScript/Guide/Statements	/de/docs/Web/JavaScript/Guide/Kontrollfluss_und_Fehlerbehandlung
/de/docs/Web/JavaScript/Guide/Ueber_JavaScript	/de/docs/Web/JavaScript/Guide/Einführung
/de/docs/Web/JavaScript/Guide/Ueber_diese_Einfuehrung	/de/docs/Web/JavaScript/Guide/Einführung
/de/docs/Web/JavaScript/Guide/Vererbung_ueberdacht	/de/docs/Web/JavaScript/Inheritance_and_the_prototype_chain
/de/docs/Web/JavaScript/Guide/Vergleiche_auf_Gleichheit_und_deren_Verwendung	/de/docs/Web/JavaScript/Vergleiche_auf_Gleichheit_und_deren_Verwendung
/de/docs/Web/JavaScript/Guide/Vordefinierte_Kernobjekte	/de/docs/Web/JavaScript/Guide
/de/docs/Web/JavaScript/Guide/Werte_Variablen_und_Literale	/de/docs/Web/JavaScript/Guide/Grammatik_und_Typen
/de/docs/Web/JavaScript/Guide/Über_Javascript	/de/docs/Web/JavaScript/Guide/Einführung
/de/docs/Web/JavaScript/Guide/Über_diese_Einführung	/de/docs/Web/JavaScript/Guide/Einführung
/de/docs/Web/JavaScript/Javascript_lernen_für_Anfänger	/de/docs/Web/JavaScript/Guide
/de/docs/Web/JavaScript/Reference/Anweisungen	/de/docs/Web/JavaScript/Reference/Statements
/de/docs/Web/JavaScript/Reference/Anweisungen/const	/de/docs/Web/JavaScript/Reference/Statements/const
/de/docs/Web/JavaScript/Reference/Anweisungen/for...in	/de/docs/Web/JavaScript/Reference/Statements/for...in
/de/docs/Web/JavaScript/Reference/Anweisungen/let	/de/docs/Web/JavaScript/Reference/Statements/let
/de/docs/Web/JavaScript/Reference/Anweisungen/var	/de/docs/Web/JavaScript/Reference/Statements/var
/de/docs/Web/JavaScript/Reference/Global_Objects/Array/flatten	/de/docs/Web/JavaScript/Reference/Global_Objects/Array/flat
/de/docs/Web/JavaScript/Reference/Global_Objects/Collator	/de/docs/Web/JavaScript/Reference/Global_Objects/Intl/Collator
/de/docs/Web/JavaScript/Reference/Global_Objects/Collator/compare	/de/docs/Web/JavaScript/Reference/Global_Objects/Intl/Collator/compare
/de/docs/Web/JavaScript/Reference/Global_Objects/Collator/prototype	/de/docs/Web/JavaScript/Reference/Global_Objects/Intl/Collator/prototype
/de/docs/Web/JavaScript/Reference/Global_Objects/Collator/resolvedOptions	/de/docs/Web/JavaScript/Reference/Global_Objects/Intl/Collator/resolvedOptions
/de/docs/Web/JavaScript/Reference/Global_Objects/Collator/supportedLocalesOf	/de/docs/Web/JavaScript/Reference/Global_Objects/Intl/Collator/supportedLocalesOf
/de/docs/Web/JavaScript/Reference/Global_Objects/DateTimeFormat	/de/docs/Web/JavaScript/Reference/Global_Objects/Intl/DateTimeFormat
/de/docs/Web/JavaScript/Reference/Global_Objects/DateTimeFormat/format	/de/docs/Web/JavaScript/Reference/Global_Objects/Intl/DateTimeFormat/format
/de/docs/Web/JavaScript/Reference/Global_Objects/DateTimeFormat/formatToParts	/de/docs/Web/JavaScript/Reference/Global_Objects/Intl/DateTimeFormat/formatToParts
/de/docs/Web/JavaScript/Reference/Global_Objects/DateTimeFormat/prototype	/de/docs/Web/JavaScript/Reference/Global_Objects/Intl/DateTimeFormat/prototype
/de/docs/Web/JavaScript/Reference/Global_Objects/DateTimeFormat/resolvedOptions	/de/docs/Web/JavaScript/Reference/Global_Objects/Intl/DateTimeFormat/resolvedOptions
/de/docs/Web/JavaScript/Reference/Global_Objects/DateTimeFormat/supportedLocalesOf	/de/docs/Web/JavaScript/Reference/Global_Objects/Intl/DateTimeFormat/supportedLocalesOf
/de/docs/Web/JavaScript/Reference/Global_Objects/NumberFormat	/de/docs/Web/JavaScript/Reference/Global_Objects/Intl/NumberFormat
/de/docs/Web/JavaScript/Reference/Global_Objects/NumberFormat/format	/de/docs/Web/JavaScript/Reference/Global_Objects/Intl/NumberFormat/format
/de/docs/Web/JavaScript/Reference/Global_Objects/NumberFormat/prototype	/de/docs/Web/JavaScript/Reference/Global_Objects/Intl/NumberFormat/prototype
/de/docs/Web/JavaScript/Reference/Global_Objects/NumberFormat/supportedLocalesOf	/de/docs/Web/JavaScript/Reference/Global_Objects/Intl/NumberFormat/supportedLocalesOf
/de/docs/Web/JavaScript/Reference/Global_Objects/PluralRules	/de/docs/Web/JavaScript/Reference/Global_Objects/Intl/PluralRules
/de/docs/Web/JavaScript/Reference/Global_Objects/PluralRules/supportedLocalesOf	/de/docs/Web/JavaScript/Reference/Global_Objects/Intl/PluralRules/supportedLocalesOf
/de/docs/Web/JavaScript/Reference/Methods_Index	/de/docs/Web/JavaScript/Reference
/de/docs/Web/JavaScript/Reference/Operators/Arithmetic_Operators	/de/docs/Web/JavaScript/Reference/Operators
/de/docs/Web/JavaScript/Reference/Properties_Index	/de/docs/Web/JavaScript/Reference
/de/docs/Web/JavaScript/Tutorials	/de/docs/Web/JavaScript
/de/docs/Web/JavaScript/java_guide	/de/docs/Web/JavaScript/Guide
/de/docs/Web/JavaScript/javascript_guide	/de/docs/Web/JavaScript/Guide
/de/docs/Web/JavaScript/javascript_guide/Ausdrücke_und_Operatoren	/de/docs/Web/JavaScript/Guide/Ausdruecke_und_Operatoren
/de/docs/Web/JavaScript/javascript_guide/Javascript_Übersicht	/de/docs/Web/JavaScript/Guide/Einführung
/de/docs/Web/JavaScript/javascript_guide/Werte,_Variable_und_Literale	/de/docs/Web/JavaScript/Guide/Grammatik_und_Typen
/de/docs/Web/JavaScript/javascript_guide/Werte,_Variablen_und_Literale	/de/docs/Web/JavaScript/Guide/Grammatik_und_Typen
/de/docs/Web/JavaScript/javascript_guide/ueber_javascript	/de/docs/Web/JavaScript/Guide/Einführung
/de/docs/Web/JavaScript/javascript_guide/ueber_javascript/Über_Javascript	/de/docs/Web/JavaScript/Guide/Einführung
/de/docs/Web/JavaScript/javascript_guide/Über_Javascript	/de/docs/Web/JavaScript/Guide/Einführung
/de/docs/Web/JavaScript/javascript_guide/Über_diese_Einführung	/de/docs/Web/JavaScript/Guide/Einführung
/de/docs/Web/JavaScript/ueber_JavaScript	/de/docs/Web/JavaScript/Guide/Einführung
/de/docs/Web/JavaScript/ueber_JavaScript/Über_Javascript	/de/docs/Web/JavaScript/Guide/Einführung
/de/docs/Web/JavaScript/Über_Javascript	/de/docs/Web/JavaScript/Guide/Einführung
/de/docs/Web/WebGL	/de/docs/Web/API/WebGL_API
/de/docs/Web/WebGL/3D-Objekte_mit_WebGL_erstellen	/de/docs/Web/API/WebGL_API/Tutorial/3D-Objekte_mit_WebGL_erstellen
/de/docs/Web/WebGL/Animierte_Texturen_in_WebGL	/de/docs/Web/API/WebGL_API/Tutorial/Animierte_Texturen_in_WebGL
/de/docs/Web/WebGL/Beleuchtung_in_WebGL	/de/docs/Web/API/WebGL_API/Tutorial/Beleuchtung_in_WebGL
/de/docs/Web/WebGL/Einführung_in_WebGL	/de/docs/Web/API/WebGL_API/Tutorial/Einführung_in_WebGL
/de/docs/Web/WebGL/Farben_mittels_Shader_in_einen_WebGL-Kontext_hinzufügen	/de/docs/Web/API/WebGL_API/Tutorial/Farben_mittels_Shader_in_einen_WebGL-Kontext_hinzufügen
/de/docs/Web/WebGL/Hinzufügen_von_2D_Inhalten_in_einen_WebGL-Kontext	/de/docs/Web/API/WebGL_API/Tutorial/Hinzufügen_von_2D_Inhalten_in_einen_WebGL-Kontext
/de/docs/Web/WebGL/Objekte_mit_WebGL_animieren	/de/docs/Web/API/WebGL_API/Tutorial/Objekte_mit_WebGL_animieren
/de/docs/Web/WebGL/Texturen_in_WebGL_verwenden	/de/docs/Web/API/WebGL_API/Tutorial/Texturen_in_WebGL_verwenden
/de/docs/WebGL	/de/docs/Web/API/WebGL_API
/de/docs/WebGL/3D-Objekte_mit_WebGL_erstellen	/de/docs/Web/API/WebGL_API/Tutorial/3D-Objekte_mit_WebGL_erstellen
/de/docs/WebGL/Animierte_Texturen_in_WebGL	/de/docs/Web/API/WebGL_API/Tutorial/Animierte_Texturen_in_WebGL
/de/docs/WebGL/Beleuchtung_in_WebGL	/de/docs/Web/API/WebGL_API/Tutorial/Beleuchtung_in_WebGL
/de/docs/WebGL/Einführung_in_WebGL	/de/docs/Web/API/WebGL_API/Tutorial/Einführung_in_WebGL
/de/docs/WebGL/Farben_mittels_Shader_in_einen_WebGL-Kontext_hinzufügen	/de/docs/Web/API/WebGL_API/Tutorial/Farben_mittels_Shader_in_einen_WebGL-Kontext_hinzufügen
/de/docs/WebGL/Hinzufügen_von_2D_Inhalten_in_einen_WebGL-Kontext	/de/docs/Web/API/WebGL_API/Tutorial/Hinzufügen_von_2D_Inhalten_in_einen_WebGL-Kontext
/de/docs/WebGL/Objekte_mit_WebGL_animieren	/de/docs/Web/API/WebGL_API/Tutorial/Objekte_mit_WebGL_animieren
/de/docs/WebGL/Texturen_in_WebGL_verwenden	/de/docs/Web/API/WebGL_API/Tutorial/Texturen_in_WebGL_verwenden
/de/docs/Webbasierte_protokoll-handler	/de/docs/Web/API/Navigator/registerProtocolHandler/Webbasierte_protokoll-handler
/de/docs/Werkzeuge	/de/docs/Tools
/de/docs/XML_Einführung	/de/docs/Web/XML/XML_Einführung
/de/docs/XSLT	/de/docs/Web/XSLT
/de/docs/Zugriff_auf_Dateien_von_Webapplikationen	/de/docs/Web/API/File/Zugriff_auf_Dateien_von_Webapplikationen
/de/docs/en	/en-US/
/de/docs/install.rdf	/de/docs/Installationsmanifest
/de/docs/meta:Help:External_editors	/de/docs/meta/Help/External_editors
/de/docs/Über_das_Mozilla_Developer_Center	/en-US/docs/Project:de/Über_das_Mozilla_Developer_Center
