# FROM-URL	TO-URL
/zh-TW/docs/AJAX	/zh-TW/docs/Web/Guide/AJAX
/zh-TW/docs/AJAX/Getting_Started	/zh-TW/docs/Web/Guide/AJAX/Getting_Started
/zh-TW/docs/AJAX/上手篇	/zh-TW/docs/Web/Guide/AJAX/Getting_Started
/zh-TW/docs/AJAX:上手篇	/zh-TW/docs/Web/Guide/AJAX/Getting_Started
/zh-TW/docs/CSS	/zh-TW/docs/Web/CSS
/zh-TW/docs/CSS/-moz-border-image	/zh-TW/docs/Web/CSS/border-image/border-image
/zh-TW/docs/CSS/@font-face	/zh-TW/docs/Web/CSS/@font-face
/zh-TW/docs/CSS/border-image	/zh-TW/docs/Web/CSS/border-image
/zh-TW/docs/CSS/border-image/border-image	/zh-TW/docs/Web/CSS/border-image/border-image
/zh-TW/docs/CSS/ime-mode	/zh-TW/docs/Web/CSS/ime-mode
/zh-TW/docs/CSS:ime-mode	/zh-TW/docs/Web/CSS/ime-mode
/zh-TW/docs/CSS_一般問題	/zh-TW/docs/Web/CSS/Common_CSS_Questions
/zh-TW/docs/CSS_動畫	/zh-TW/docs/Web/CSS/CSS_Animations/Using_CSS_animations
/zh-TW/docs/CSS_轉場	/zh-TW/docs/Web/CSS/CSS_Transitions/Using_CSS_transitions
/zh-TW/docs/CSS_過渡	/zh-TW/docs/Web/CSS/CSS_Transitions/Using_CSS_transitions
/zh-TW/docs/Canvas_tutorial	/en-US/docs/Web/API/Canvas_API/Tutorial
/zh-TW/docs/Canvas_教學/基本用法	/zh-TW/docs/Canvas_tutorial/Basic_usage
/zh-TW/docs/Canvas_教學/繪製圖形	/zh-TW/docs/Canvas_tutorial/Drawing_shapes
/zh-TW/docs/Consistent_List_Indentation	/zh-TW/docs/Web/CSS/CSS_Lists_and_Counters/Consistent_list_indentation
/zh-TW/docs/Core_JavaScript_1.5_教學	/zh-TW/docs/Web/JavaScript/Guide
/zh-TW/docs/Core_JavaScript_1.5_教學/JavaScript_概要	/zh-TW/docs/Web/JavaScript/Obsolete_Pages/Obsolete_Pages/Obsolete_Pages/JavaScript_概要
/zh-TW/docs/Core_JavaScript_1.5_教學/LiveConnect_概要	/zh-TW/docs/Web/JavaScript/Obsolete_Pages/Obsolete_Pages/Obsolete_Pages/LiveConnect_概要
/zh-TW/docs/Core_JavaScript_1.5_教學/LiveConnect_概要/JavaScript_向_Java_的通訊	/zh-TW/docs/Web/JavaScript/Obsolete_Pages/Obsolete_Pages/Obsolete_Pages/LiveConnect_概要/JavaScript_向_Java_的通訊
/zh-TW/docs/Core_JavaScript_1.5_教學/LiveConnect_概要/Java_向_JavaScript_的通訊	/zh-TW/docs/Web/JavaScript/Obsolete_Pages/Obsolete_Pages/Obsolete_Pages/LiveConnect_概要/Java_向_JavaScript_的通訊
/zh-TW/docs/Core_JavaScript_1.5_教學/LiveConnect_概要/Java_向_JavaScript_的通訊/LiveConnect_類別的使用	/zh-TW/docs/Web/JavaScript/Obsolete_Pages/Obsolete_Pages/Obsolete_Pages/LiveConnect_概要/Java_向_JavaScript_的通訊/LiveConnect_類別的使用
/zh-TW/docs/Core_JavaScript_1.5_教學/LiveConnect_概要/包裝器的運用	/zh-TW/docs/Web/JavaScript/Obsolete_Pages/Obsolete_Pages/Obsolete_Pages/LiveConnect_概要/包裝器的運用
/zh-TW/docs/Core_JavaScript_1.5_教學/LiveConnect_概要/資料類型的轉換	/zh-TW/docs/Web/JavaScript/Obsolete_Pages/Obsolete_Pages/Obsolete_Pages/LiveConnect_概要/資料類型的轉換
/zh-TW/docs/Core_JavaScript_1.5_教學/LiveConnect_概要/資料類型的轉換/從_JavaScript_到_Java_的轉換	/zh-TW/docs/Web/JavaScript/Obsolete_Pages/Obsolete_Pages/Obsolete_Pages/LiveConnect_概要/資料類型的轉換/從_JavaScript_到_Java_的轉換
/zh-TW/docs/Core_JavaScript_1.5_教學/LiveConnect_概要/資料類型的轉換/從_Java_到_JavaScript_的轉換	/zh-TW/docs/Web/JavaScript/Obsolete_Pages/Obsolete_Pages/Obsolete_Pages/LiveConnect_概要/資料類型的轉換/從_Java_到_JavaScript_的轉換
/zh-TW/docs/Core_JavaScript_1.5_教學/Unicode	/zh-TW/docs/Web/JavaScript/Obsolete_Pages/Obsolete_Pages/Obsolete_Pages/Unicode
/zh-TW/docs/Core_JavaScript_1.5_教學/arguments_物件的使用	/zh-TW/docs/Web/JavaScript/Reference/Functions/arguments
/zh-TW/docs/Core_JavaScript_1.5_教學/以類別為基礎的語言_vs._以原型為基礎的語言	/zh-TW/docs/Web/JavaScript/Obsolete_Pages/Obsolete_Pages/Obsolete_Pages/以類別為基礎的語言_vs._以原型為基礎的語言
/zh-TW/docs/Core_JavaScript_1.5_教學/例外處理語法	/zh-TW/docs/Web/JavaScript/Obsolete_Pages/Obsolete_Pages/Obsolete_Pages/例外處理語法
/zh-TW/docs/Core_JavaScript_1.5_教學/例外處理語法/throw_語法	/zh-TW/docs/Web/JavaScript/Obsolete_Pages/Obsolete_Pages/Obsolete_Pages/例外處理語法/throw_語法
/zh-TW/docs/Core_JavaScript_1.5_教學/例外處理語法/try...catch_語法	/zh-TW/docs/Web/JavaScript/Obsolete_Pages/Obsolete_Pages/Obsolete_Pages/例外處理語法/try...catch_語法
/zh-TW/docs/Core_JavaScript_1.5_教學/值	/zh-TW/docs/Web/JavaScript/Obsolete_Pages/Obsolete_Pages/Obsolete_Pages/值
/zh-TW/docs/Core_JavaScript_1.5_教學/再談屬性的繼承	/zh-TW/docs/Web/JavaScript/Obsolete_Pages/Obsolete_Pages/Obsolete_Pages/再談屬性的繼承
/zh-TW/docs/Core_JavaScript_1.5_教學/再談屬性的繼承/實體關係的確定	/zh-TW/docs/Web/JavaScript/Obsolete_Pages/Obsolete_Pages/Obsolete_Pages/再談屬性的繼承/實體關係的確定
/zh-TW/docs/Core_JavaScript_1.5_教學/再談屬性的繼承/局域值和繼承值	/zh-TW/docs/Web/JavaScript/Obsolete_Pages/Obsolete_Pages/Obsolete_Pages/再談屬性的繼承/局域值和繼承值
/zh-TW/docs/Core_JavaScript_1.5_教學/再談屬性的繼承/建構子中的全域資訊	/zh-TW/docs/Web/JavaScript/Obsolete_Pages/Obsolete_Pages/Obsolete_Pages/再談屬性的繼承/建構子中的全域資訊
/zh-TW/docs/Core_JavaScript_1.5_教學/再談屬性的繼承/沒有多重繼承	/zh-TW/docs/Web/JavaScript/Obsolete_Pages/Obsolete_Pages/Obsolete_Pages/再談屬性的繼承/沒有多重繼承
/zh-TW/docs/Core_JavaScript_1.5_教學/函數的呼叫	/zh-TW/docs/Web/JavaScript/Obsolete_Pages/Obsolete_Pages/Obsolete_Pages/函數的呼叫
/zh-TW/docs/Core_JavaScript_1.5_教學/函數的定義	/zh-TW/docs/Web/JavaScript/Obsolete_Pages/Obsolete_Pages/Obsolete_Pages/函數的定義
/zh-TW/docs/Core_JavaScript_1.5_教學/區塊文法	/zh-TW/docs/Web/JavaScript/Obsolete_Pages/Obsolete_Pages/Obsolete_Pages/區塊語法
/zh-TW/docs/Core_JavaScript_1.5_教學/區塊語法	/zh-TW/docs/Web/JavaScript/Obsolete_Pages/Obsolete_Pages/Obsolete_Pages/區塊語法
/zh-TW/docs/Core_JavaScript_1.5_教學/字面表達	/zh-TW/docs/Web/JavaScript/Obsolete_Pages/Obsolete_Pages/Obsolete_Pages/字面表達
/zh-TW/docs/Core_JavaScript_1.5_教學/常數	/zh-TW/docs/Web/JavaScript/Obsolete_Pages/Obsolete_Pages/Obsolete_Pages/常數
/zh-TW/docs/Core_JavaScript_1.5_教學/建立新的物件	/zh-TW/docs/Web/JavaScript/Obsolete_Pages/Obsolete_Pages/Obsolete_Pages/建立新的物件
/zh-TW/docs/Core_JavaScript_1.5_教學/建立新的物件/物件初始化子的使用	/zh-TW/docs/Web/JavaScript/Obsolete_Pages/Obsolete_Pages/Obsolete_Pages/新物件的建立/物件初始化子的使用
/zh-TW/docs/Core_JavaScript_1.5_教學/循環語法	/zh-TW/docs/Web/JavaScript/Obsolete_Pages/Obsolete_Pages/Obsolete_Pages/循環語法
/zh-TW/docs/Core_JavaScript_1.5_教學/循環語法/break_語法	/zh-TW/docs/Web/JavaScript/Obsolete_Pages/Obsolete_Pages/Obsolete_Pages/循環語法/break_語法
/zh-TW/docs/Core_JavaScript_1.5_教學/循環語法/continue_語法	/zh-TW/docs/Web/JavaScript/Obsolete_Pages/Obsolete_Pages/Obsolete_Pages/循環語法/continue_語法
/zh-TW/docs/Core_JavaScript_1.5_教學/循環語法/do...while_語法	/zh-TW/docs/Web/JavaScript/Obsolete_Pages/Obsolete_Pages/Obsolete_Pages/循環語法/do...while_語法
/zh-TW/docs/Core_JavaScript_1.5_教學/循環語法/for_語法	/zh-TW/docs/Web/JavaScript/Obsolete_Pages/Obsolete_Pages/Obsolete_Pages/循環語法/for_語法
/zh-TW/docs/Core_JavaScript_1.5_教學/循環語法/label_語法	/zh-TW/docs/Web/JavaScript/Obsolete_Pages/Obsolete_Pages/Obsolete_Pages/循環語法/label_語法
/zh-TW/docs/Core_JavaScript_1.5_教學/循環語法/while_語法	/zh-TW/docs/Web/JavaScript/Obsolete_Pages/Obsolete_Pages/Obsolete_Pages/循環語法/while_語法
/zh-TW/docs/Core_JavaScript_1.5_教學/文法	/zh-TW/docs/Core_JavaScript_1.5_教學/語法
/zh-TW/docs/Core_JavaScript_1.5_教學/新物件的建立	/zh-TW/docs/Web/JavaScript/Obsolete_Pages/Obsolete_Pages/Obsolete_Pages/新物件的建立
/zh-TW/docs/Core_JavaScript_1.5_教學/新物件的建立/Getter_和_Setter_的定義	/zh-TW/docs/Web/JavaScript/Obsolete_Pages/Obsolete_Pages/Obsolete_Pages/新物件的建立/Getter_和_Setter_的定義
/zh-TW/docs/Core_JavaScript_1.5_教學/新物件的建立/使用_this_取得物件的參考	/zh-TW/docs/Web/JavaScript/Obsolete_Pages/Obsolete_Pages/Obsolete_Pages/新物件的建立/使用_this_取得物件的參考
/zh-TW/docs/Core_JavaScript_1.5_教學/新物件的建立/屬性的刪除	/zh-TW/docs/Web/JavaScript/Obsolete_Pages/Obsolete_Pages/Obsolete_Pages/新物件的建立/屬性的刪除
/zh-TW/docs/Core_JavaScript_1.5_教學/新物件的建立/建構子函數的使用	/zh-TW/docs/Web/JavaScript/Obsolete_Pages/Obsolete_Pages/Obsolete_Pages/新物件的建立/建構子函數的使用
/zh-TW/docs/Core_JavaScript_1.5_教學/新物件的建立/方法的定義	/zh-TW/docs/Web/JavaScript/Obsolete_Pages/Obsolete_Pages/Obsolete_Pages/新物件的建立/方法的定義
/zh-TW/docs/Core_JavaScript_1.5_教學/新物件的建立/物件初始化子的使用	/zh-TW/docs/Web/JavaScript/Obsolete_Pages/Obsolete_Pages/Obsolete_Pages/新物件的建立/物件初始化子的使用
/zh-TW/docs/Core_JavaScript_1.5_教學/新物件的建立/物件屬性的索引	/zh-TW/docs/Web/JavaScript/Obsolete_Pages/Obsolete_Pages/Obsolete_Pages/新物件的建立/物件屬性的索引
/zh-TW/docs/Core_JavaScript_1.5_教學/新物件的建立/針對物件的類型定義屬性	/zh-TW/docs/Web/JavaScript/Obsolete_Pages/Obsolete_Pages/Obsolete_Pages/新物件的建立/針對物件的類型定義屬性
/zh-TW/docs/Core_JavaScript_1.5_教學/條件文法	/zh-TW/docs/Web/JavaScript/Obsolete_Pages/Obsolete_Pages/Obsolete_Pages/條件語法
/zh-TW/docs/Core_JavaScript_1.5_教學/條件語法	/zh-TW/docs/Web/JavaScript/Obsolete_Pages/Obsolete_Pages/Obsolete_Pages/條件語法
/zh-TW/docs/Core_JavaScript_1.5_教學/正則表達式	/zh-TW/docs/Core_JavaScript_1.5_教學/正規表達式
/zh-TW/docs/Core_JavaScript_1.5_教學/正則表達式模式的編寫	/zh-TW/docs/Web/JavaScript/Obsolete_Pages/Obsolete_Pages/Obsolete_Pages/正規表達式模式的編寫
/zh-TW/docs/Core_JavaScript_1.5_教學/正則表達式的建立	/zh-TW/docs/Web/JavaScript/Obsolete_Pages/Obsolete_Pages/Obsolete_Pages/正規表達式的建立
/zh-TW/docs/Core_JavaScript_1.5_教學/正則表達式的運用	/zh-TW/docs/Web/JavaScript/Obsolete_Pages/Obsolete_Pages/Obsolete_Pages/正規表達式的運用
/zh-TW/docs/Core_JavaScript_1.5_教學/正則表達式的運用/使用標誌的進階搜尋	/zh-TW/docs/Web/JavaScript/Obsolete_Pages/Obsolete_Pages/Obsolete_Pages/正規表達式的運用/使用標誌的進階搜尋
/zh-TW/docs/Core_JavaScript_1.5_教學/正則表達式的運用/括弧子字串的比對結果的運用	/zh-TW/docs/Web/JavaScript/Obsolete_Pages/Obsolete_Pages/Obsolete_Pages/正規表達式的運用/括弧子字串的比對結果的運用
/zh-TW/docs/Core_JavaScript_1.5_教學/正則表達式的運用/正則表達式的範例	/zh-TW/docs/Web/JavaScript/Obsolete_Pages/Obsolete_Pages/Obsolete_Pages/正規表達式的運用/正規表達式的範例
/zh-TW/docs/Core_JavaScript_1.5_教學/正規表達式模式的編寫	/zh-TW/docs/Web/JavaScript/Obsolete_Pages/Obsolete_Pages/Obsolete_Pages/正規表達式模式的編寫
/zh-TW/docs/Core_JavaScript_1.5_教學/正規表達式的建立	/zh-TW/docs/Web/JavaScript/Obsolete_Pages/Obsolete_Pages/Obsolete_Pages/正規表達式的建立
/zh-TW/docs/Core_JavaScript_1.5_教學/正規表達式的運用	/zh-TW/docs/Web/JavaScript/Obsolete_Pages/Obsolete_Pages/Obsolete_Pages/正規表達式的運用
/zh-TW/docs/Core_JavaScript_1.5_教學/正規表達式的運用/使用標誌的進階搜尋	/zh-TW/docs/Web/JavaScript/Obsolete_Pages/Obsolete_Pages/Obsolete_Pages/正規表達式的運用/使用標誌的進階搜尋
/zh-TW/docs/Core_JavaScript_1.5_教學/正規表達式的運用/括弧子字串的比對結果的運用	/zh-TW/docs/Web/JavaScript/Obsolete_Pages/Obsolete_Pages/Obsolete_Pages/正規表達式的運用/括弧子字串的比對結果的運用
/zh-TW/docs/Core_JavaScript_1.5_教學/正規表達式的運用/正則表達式的範例	/zh-TW/docs/Web/JavaScript/Obsolete_Pages/Obsolete_Pages/Obsolete_Pages/正規表達式的運用/正規表達式的範例
/zh-TW/docs/Core_JavaScript_1.5_教學/正規表達式的運用/正規表達式的範例	/zh-TW/docs/Web/JavaScript/Obsolete_Pages/Obsolete_Pages/Obsolete_Pages/正規表達式的運用/正規表達式的範例
/zh-TW/docs/Core_JavaScript_1.5_教學/物件和屬性	/zh-TW/docs/Web/JavaScript/Obsolete_Pages/Obsolete_Pages/Obsolete_Pages/物件和屬性
/zh-TW/docs/Core_JavaScript_1.5_教學/物件的操作語法	/zh-TW/docs/Web/JavaScript/Obsolete_Pages/Obsolete_Pages/Obsolete_Pages/物件的操作語法
/zh-TW/docs/Core_JavaScript_1.5_教學/繼承	/zh-TW/docs/Web/JavaScript/Obsolete_Pages/Obsolete_Pages/Obsolete_Pages/繼承
/zh-TW/docs/Core_JavaScript_1.5_教學/職員的例子	/zh-TW/docs/Web/JavaScript/Obsolete_Pages/Obsolete_Pages/Obsolete_Pages/職員的例子
/zh-TW/docs/Core_JavaScript_1.5_教學/職員的例子/更靈活的建構子	/zh-TW/docs/Web/JavaScript/Obsolete_Pages/Obsolete_Pages/Obsolete_Pages/職員的例子/更靈活的建構子
/zh-TW/docs/Core_JavaScript_1.5_教學/職員的例子/物件的屬性	/zh-TW/docs/Web/JavaScript/Obsolete_Pages/Obsolete_Pages/Obsolete_Pages/職員的例子/物件的屬性
/zh-TW/docs/Core_JavaScript_1.5_教學/職員的例子/物件的屬性/屬性的加入	/zh-TW/docs/Web/JavaScript/Obsolete_Pages/Obsolete_Pages/Obsolete_Pages/職員的例子/物件的屬性/屬性的加入
/zh-TW/docs/Core_JavaScript_1.5_教學/職員的例子/物件的屬性/屬性的繼承	/zh-TW/docs/Web/JavaScript/Obsolete_Pages/Obsolete_Pages/Obsolete_Pages/職員的例子/物件的屬性/屬性的繼承
/zh-TW/docs/Core_JavaScript_1.5_教學/職員的例子/階層的建立	/zh-TW/docs/Web/JavaScript/Obsolete_Pages/Obsolete_Pages/Obsolete_Pages/職員的例子/階層的建立
/zh-TW/docs/Core_JavaScript_1.5_教學/表達式	/zh-TW/docs/Web/JavaScript/Obsolete_Pages/Obsolete_Pages/Obsolete_Pages/表達式
/zh-TW/docs/Core_JavaScript_1.5_教學/註解	/zh-TW/docs/Web/JavaScript/Obsolete_Pages/Obsolete_Pages/Obsolete_Pages/註解
/zh-TW/docs/Core_JavaScript_1.5_教學/變數	/zh-TW/docs/Web/JavaScript/Obsolete_Pages/Obsolete_Pages/Obsolete_Pages/變數
/zh-TW/docs/Core_JavaScript_1.5_教學/迭代器和產生器	/zh-TW/docs/Web/JavaScript/Obsolete_Pages/Obsolete_Pages/Obsolete_Pages/迭代器和產生器
/zh-TW/docs/Core_JavaScript_1.5_教學/運算子	/zh-TW/docs/Web/JavaScript/Obsolete_Pages/Obsolete_Pages/Obsolete_Pages/運算子
/zh-TW/docs/Core_JavaScript_1.5_教學/運算子/代入運算子	/zh-TW/docs/Web/JavaScript/Obsolete_Pages/Obsolete_Pages/Obsolete_Pages/運算子/代入運算子
/zh-TW/docs/Core_JavaScript_1.5_教學/運算子/位元運算子	/zh-TW/docs/Web/JavaScript/Obsolete_Pages/Obsolete_Pages/Obsolete_Pages/運算子/位元運算子
/zh-TW/docs/Core_JavaScript_1.5_教學/運算子/字串運算子	/zh-TW/docs/Web/JavaScript/Obsolete_Pages/Obsolete_Pages/Obsolete_Pages/運算子/字串運算子
/zh-TW/docs/Core_JavaScript_1.5_教學/運算子/比較運算子	/zh-TW/docs/Web/JavaScript/Obsolete_Pages/Obsolete_Pages/Obsolete_Pages/運算子/比較運算子
/zh-TW/docs/Core_JavaScript_1.5_教學/運算子/特殊運算子	/zh-TW/docs/Web/JavaScript/Obsolete_Pages/Obsolete_Pages/Obsolete_Pages/運算子/特殊運算子
/zh-TW/docs/Core_JavaScript_1.5_教學/運算子/算術運算子	/zh-TW/docs/Web/JavaScript/Obsolete_Pages/Obsolete_Pages/Obsolete_Pages/運算子/算術運算子
/zh-TW/docs/Core_JavaScript_1.5_教學/運算子/邏輯運算子	/zh-TW/docs/Web/JavaScript/Obsolete_Pages/Obsolete_Pages/Obsolete_Pages/運算子/邏輯運算子
/zh-TW/docs/Core_JavaScript_1.5_教學/閉包的運用	/zh-TW/docs/Web/JavaScript/Obsolete_Pages/Obsolete_Pages/Obsolete_Pages/閉包的運用
/zh-TW/docs/Core_JavaScript_1.5_教學/關於	/zh-TW/docs/Web/JavaScript/Obsolete_Pages/Obsolete_Pages/Obsolete_Pages/關於
/zh-TW/docs/Core_JavaScript_1.5_教學/陣列的運用	/zh-TW/docs/Web/JavaScript/Obsolete_Pages/Obsolete_Pages/Obsolete_Pages/陣列的運用
/zh-TW/docs/Core_JavaScript_1.5_教學/預先定義的函數	/zh-TW/docs/Web/JavaScript/Obsolete_Pages/Obsolete_Pages/Obsolete_Pages/預先定義的函數
/zh-TW/docs/Core_JavaScript_1.5_教學/預先定義的函數/Number_和_String_函數	/zh-TW/docs/Web/JavaScript/Obsolete_Pages/Obsolete_Pages/Obsolete_Pages/預先定義的函數/Number_和_String_函數
/zh-TW/docs/Core_JavaScript_1.5_教學/預先定義的函數/escape_和_unescape_函數	/zh-TW/docs/Web/JavaScript/Obsolete_Pages/Obsolete_Pages/Obsolete_Pages/預先定義的函數/escape_和_unescape_函數
/zh-TW/docs/Core_JavaScript_1.5_教學/預先定義的函數/eval_函數	/zh-TW/docs/Web/JavaScript/Obsolete_Pages/Obsolete_Pages/Obsolete_Pages/預先定義的函數/eval_函數
/zh-TW/docs/Core_JavaScript_1.5_教學/預先定義的函數/isFinite_函數	/zh-TW/docs/Web/JavaScript/Obsolete_Pages/Obsolete_Pages/Obsolete_Pages/預先定義的函數/isFinite_函數
/zh-TW/docs/Core_JavaScript_1.5_教學/預先定義的函數/isNaN_函數	/zh-TW/docs/Web/JavaScript/Obsolete_Pages/Obsolete_Pages/Obsolete_Pages/預先定義的函數/isNaN_函數
/zh-TW/docs/Core_JavaScript_1.5_教學/預先定義的函數/parseInt_和_parseFloat_函數	/zh-TW/docs/Web/JavaScript/Obsolete_Pages/Obsolete_Pages/Obsolete_Pages/預先定義的函數/parseInt_和_parseFloat_函數
/zh-TW/docs/Core_JavaScript_1.5_教學/預先定義的核心物件	/zh-TW/docs/Web/JavaScript/Obsolete_Pages/Obsolete_Pages/Obsolete_Pages/預先定義的核心物件
/zh-TW/docs/Core_JavaScript_1.5_教學/預先定義的核心物件/Array_物件	/zh-TW/docs/Web/JavaScript/Obsolete_Pages/Obsolete_Pages/Obsolete_Pages/預先定義的核心物件/Array_物件
/zh-TW/docs/Core_JavaScript_1.5_教學/預先定義的核心物件/Boolean_物件	/zh-TW/docs/Web/JavaScript/Obsolete_Pages/Obsolete_Pages/Obsolete_Pages/預先定義的核心物件/Boolean_物件
/zh-TW/docs/Core_JavaScript_1.5_教學/預先定義的核心物件/Date_物件	/zh-TW/docs/Web/JavaScript/Obsolete_Pages/Obsolete_Pages/Obsolete_Pages/預先定義的核心物件/Date_物件
/zh-TW/docs/Core_JavaScript_1.5_教學/預先定義的核心物件/Function_物件	/zh-TW/docs/Web/JavaScript/Obsolete_Pages/Obsolete_Pages/Obsolete_Pages/預先定義的核心物件/Function_物件
/zh-TW/docs/Core_JavaScript_1.5_教學/預先定義的核心物件/Math_物件	/zh-TW/docs/Web/JavaScript/Obsolete_Pages/Obsolete_Pages/Obsolete_Pages/預先定義的核心物件/Math_物件
/zh-TW/docs/Core_JavaScript_1.5_教學/預先定義的核心物件/Number_物件	/zh-TW/docs/Web/JavaScript/Obsolete_Pages/Obsolete_Pages/Obsolete_Pages/預先定義的核心物件/Number_物件
/zh-TW/docs/Core_JavaScript_1.5_教學/預先定義的核心物件/RegExp_物件	/zh-TW/docs/Web/JavaScript/Obsolete_Pages/Obsolete_Pages/Obsolete_Pages/預先定義的核心物件/RegExp_物件
/zh-TW/docs/Core_JavaScript_1.5_教學/預先定義的核心物件/String_物件	/zh-TW/docs/Web/JavaScript/Obsolete_Pages/Obsolete_Pages/Obsolete_Pages/預先定義的核心物件/String_物件
/zh-TW/docs/Core_JavaScript_1.5_正規表達式的建立/正規表達式的建立	/zh-TW/docs/Web/JavaScript/Obsolete_Pages/Obsolete_Pages/Obsolete_Pages/正規表達式的建立
/zh-TW/docs/DOM	/en-US/docs/Web/API/Document_Object_Model
/zh-TW/docs/DOM/XMLHttpRequest	/zh-TW/docs/Web/API/XMLHttpRequest
/zh-TW/docs/DOM/XMLHttpRequest/FormData	/zh-TW/docs/Web/API/FormData
/zh-TW/docs/DOM/XMLHttpRequest/Synchronous_and_Asynchronous_Requests	/zh-TW/docs/Web/API/XMLHttpRequest/Synchronous_and_Asynchronous_Requests
/zh-TW/docs/DOM/XMLHttpRequest/Using_XMLHttpRequest	/zh-TW/docs/Web/API/XMLHttpRequest/Using_XMLHttpRequest
/zh-TW/docs/DOM/window.location	/zh-TW/docs/Web/API/Window/location
/zh-TW/docs/DOM_中的空白字元	/zh-TW/docs/Web/API/Document_Object_Model/Whitespace
/zh-TW/docs/Developer_Guide	/zh-TW/docs/Mozilla/Developer_guide
/zh-TW/docs/Developer_Guide/原始碼	/zh-TW/docs/Mozilla/Developer_guide/Source_Code
/zh-TW/docs/Developer_guide_temp	/zh-TW/docs/Mozilla/Developer_guide
/zh-TW/docs/Developer_guide_temp/Build_Instructions	/zh-TW/docs/Mozilla/Developer_guide/Build_Instructions
/zh-TW/docs/Developer_guide_temp/Build_Instructions/Windows_Prerequisites	/zh-TW/docs/Mozilla/Developer_guide/Build_Instructions/Windows_Prerequisites
/zh-TW/docs/Developer_guide_temp/介紹	/zh-TW/docs/Mozilla/Developer_guide/Introduction
/zh-TW/docs/Developer_guide_temp/原始碼	/zh-TW/docs/Mozilla/Developer_guide/Source_Code
/zh-TW/docs/DragDrop/Drag_and_Drop	/zh-TW/docs/Web/API/HTML_Drag_and_Drop_API
/zh-TW/docs/Drawing_text_using_a_canvas	/zh-TW/docs/Web/API/Canvas_API/Tutorial/Drawing_text
/zh-TW/docs/Firefox_2	/zh-TW/docs/Mozilla/Firefox/Releases/2
/zh-TW/docs/Firefox_2_技術文件	/zh-TW/docs/Mozilla/Firefox/Releases/2
/zh-TW/docs/Firefox_2_的安全功能	/zh-TW/docs/Mozilla/Firefox/Releases/2/Security_changes
/zh-TW/docs/Firefox_3.1_技術文件	/zh-TW/docs/Firefox_3.5_技術文件
/zh-TW/docs/Firefox_3_CSS_Improvement	/zh-TW/docs/Mozilla/Firefox/Releases/3/Firefox_3_CSS_Improvement
/zh-TW/docs/Firefox_3_Dom_Improvements	/zh-TW/docs/Mozilla/Firefox/Releases/3/DOM_improvements
/zh-TW/docs/Firefox_3_Online_and_Offline_Events	/zh-TW/docs/Web/API/NavigatorOnLine/Online_and_offline_events
/zh-TW/docs/Firefox_3_Web-based_protocol_handler	/zh-TW/docs/Web/API/Navigator/registerProtocolHandler/Web-based_protocol_handlers
/zh-TW/docs/Firefox_3_for_developers	/zh-TW/docs/Mozilla/Firefox/Releases/3
/zh-TW/docs/Firefox_3_supports_Cross-site_XMLHttpRequest	/zh-TW/docs/Cross-site_XMLHttpRequest
/zh-TW/docs/Firefox_3_技術文件	/zh-TW/docs/Mozilla/Firefox/Releases/3
/zh-TW/docs/Firefox_4_for_developers	/zh-TW/docs/Mozilla/Firefox/Releases/4
/zh-TW/docs/Firefox_4_for_developers/Firefox_4_開發者新功能概覽	/zh-TW/docs/Mozilla/Firefox/Releases/4/Firefox_4_開發者新功能概覽
/zh-TW/docs/Firefox_4_開發者新功能概覽	/zh-TW/docs/Mozilla/Firefox/Releases/4/Firefox_4_開發者新功能概覽
/zh-TW/docs/Firefox_7_for_developers	/zh-TW/docs/Mozilla/Firefox/Releases/7
/zh-TW/docs/Games/Tutorials/2D_Breakout_game_pure_JavaScript/球拍和鍵盤控制	/zh-TW/docs/Games/Tutorials/2D_Breakout_game_pure_JavaScript/Paddle_and_keyboard_controls
/zh-TW/docs/Games/Workflows	/zh-TW/docs/Games/Tutorials
/zh-TW/docs/Games/Workflows/2D_Breakout_game_pure_JavaScript	/zh-TW/docs/Games/Tutorials/2D_Breakout_game_pure_JavaScript
/zh-TW/docs/Games/Workflows/2D_Breakout_game_pure_JavaScript/Bounce_off_the_walls	/zh-TW/docs/Games/Tutorials/2D_Breakout_game_pure_JavaScript/Bounce_off_the_walls
/zh-TW/docs/Games/Workflows/2D_Breakout_game_pure_JavaScript/Create_the_Canvas_and_draw_on_it	/zh-TW/docs/Games/Tutorials/2D_Breakout_game_pure_JavaScript/Create_the_Canvas_and_draw_on_it
/zh-TW/docs/Games/Workflows/2D_Breakout_game_pure_JavaScript/Move_the_ball	/zh-TW/docs/Games/Tutorials/2D_Breakout_game_pure_JavaScript/Move_the_ball
/zh-TW/docs/Games/Workflows/2D_Breakout_game_pure_JavaScript/球拍和鍵盤控制	/zh-TW/docs/Games/Tutorials/2D_Breakout_game_pure_JavaScript/Paddle_and_keyboard_controls
/zh-TW/docs/Glossary/偽元素	/zh-TW/docs/Glossary/Pseudo-element
/zh-TW/docs/Glossary/字元	/zh-TW/docs/Glossary/Character
/zh-TW/docs/Glossary/字元編碼	/zh-TW/docs/Glossary/character_encoding
/zh-TW/docs/Glossary/布林	/zh-TW/docs/Glossary/Boolean
/zh-TW/docs/Glossary/抽象化	/zh-TW/docs/Glossary/Abstraction
/zh-TW/docs/Glossary/瀏覽器	/zh-TW/docs/Glossary/Browser
/zh-TW/docs/Glossary/物件導向程式設計(OOP)	/zh-TW/docs/Glossary/OOP
/zh-TW/docs/Glossary/資料結構	/zh-TW/docs/Glossary/Data_structure
/zh-TW/docs/Glossary/陣列	/zh-TW/docs/Glossary/array
/zh-TW/docs/HTML	/zh-TW/docs/Web/HTML
/zh-TW/docs/HTML/Canvas	/zh-TW/docs/Web/API/Canvas_API
/zh-TW/docs/HTML/Element	/zh-TW/docs/Web/HTML/Element
/zh-TW/docs/HTML/Element/HTML_元素	/zh-TW/docs/Web/HTML/Element
/zh-TW/docs/HTML/Element/a	/zh-TW/docs/Web/HTML/Element/a
/zh-TW/docs/HTML/HTML5	/zh-TW/docs/Web/Guide/HTML/HTML5
/zh-TW/docs/HTML/HTML5_表單	/zh-TW/docs/Learn/HTML/Forms
/zh-TW/docs/HTML/HTML_元素	/zh-TW/docs/Web/HTML/HTML_元素
/zh-TW/docs/HTML/Introduction	/zh-CN/docs/learn/HTML/Introduction_to_HTML
/zh-TW/docs/HTTP	/zh-TW/docs/Web/HTTP
/zh-TW/docs/HTTP/Access_control_CORS	/zh-TW/docs/Web/HTTP/CORS
/zh-TW/docs/HTTP/Browser_detection_using_the_user_agent	/zh-TW/docs/Web/HTTP/Browser_detection_using_the_user_agent
/zh-TW/docs/HTTP/Link_prefetching_FAQ	/zh-TW/docs/Web/HTTP/Link_prefetching_FAQ
/zh-TW/docs/HTTP/Response_codes	/zh-TW/docs/Web/HTTP/Status
/zh-TW/docs/HTTP/X-Frame-Options	/zh-TW/docs/Web/HTTP/Headers/X-Frame-Options
/zh-TW/docs/HTTP/data_URIs	/zh-TW/docs/Web/HTTP/data_URIs
/zh-TW/docs/IndexedDB	/zh-TW/docs/Web/API/IndexedDB_API
/zh-TW/docs/IndexedDB/Basic_Concepts_Behind_IndexedDB	/zh-TW/docs/Web/API/IndexedDB_API/Basic_Concepts_Behind_IndexedDB
/zh-TW/docs/IndexedDB/Using_IndexedDB	/zh-TW/docs/Web/API/IndexedDB_API/Using_IndexedDB
/zh-TW/docs/JavaScript	/zh-TW/docs/Web/JavaScript
/zh-TW/docs/JavaScript/About_JavaScript	/zh-TW/docs/Web/JavaScript/About_JavaScript
/zh-TW/docs/JavaScript/Guide	/zh-TW/docs/Web/JavaScript/Guide
/zh-TW/docs/JavaScript/Guide/Details_of_the_Object_Model	/zh-TW/docs/Web/JavaScript/Guide/Details_of_the_Object_Model
/zh-TW/docs/JavaScript/Guide/Functions	/zh-TW/docs/Web/JavaScript/Guide/Functions
/zh-TW/docs/JavaScript/Guide/JavaScript_Overview	/zh-TW/docs/Web/JavaScript/Guide/Introduction
/zh-TW/docs/JavaScript/Guide/JavaScript_Overview-redirect-1	/zh-TW/docs/Web/JavaScript/Guide/Introduction
/zh-TW/docs/JavaScript/Guide/JavaScript_概觀	/zh-TW/docs/Web/JavaScript/Guide/Introduction
/zh-TW/docs/JavaScript/Guide/JavaScript_概觀（JavaScript_Overview）	/zh-TW/docs/Web/JavaScript/Guide/Introduction
/zh-TW/docs/JavaScript/Guide/Obsolete_Pages	/zh-TW/docs/Web/JavaScript/Guide
/zh-TW/docs/JavaScript/Guide/Obsolete_Pages/JavaScript_概要	/zh-TW/docs/Web/JavaScript/Obsolete_Pages/Obsolete_Pages/Obsolete_Pages/JavaScript_概要
/zh-TW/docs/JavaScript/Guide/Obsolete_Pages/LiveConnect_概要	/zh-TW/docs/Web/JavaScript/Obsolete_Pages/Obsolete_Pages/Obsolete_Pages/LiveConnect_概要
/zh-TW/docs/JavaScript/Guide/Obsolete_Pages/LiveConnect_概要/JavaScript_向_Java_的通訊	/zh-TW/docs/Web/JavaScript/Obsolete_Pages/Obsolete_Pages/Obsolete_Pages/LiveConnect_概要/JavaScript_向_Java_的通訊
/zh-TW/docs/JavaScript/Guide/Obsolete_Pages/LiveConnect_概要/Java_向_JavaScript_的通訊	/zh-TW/docs/Web/JavaScript/Obsolete_Pages/Obsolete_Pages/Obsolete_Pages/LiveConnect_概要/Java_向_JavaScript_的通訊
/zh-TW/docs/JavaScript/Guide/Obsolete_Pages/LiveConnect_概要/Java_向_JavaScript_的通訊/LiveConnect_類別的使用	/zh-TW/docs/Web/JavaScript/Obsolete_Pages/Obsolete_Pages/Obsolete_Pages/LiveConnect_概要/Java_向_JavaScript_的通訊/LiveConnect_類別的使用
/zh-TW/docs/JavaScript/Guide/Obsolete_Pages/LiveConnect_概要/包裝器的運用	/zh-TW/docs/Web/JavaScript/Obsolete_Pages/Obsolete_Pages/Obsolete_Pages/LiveConnect_概要/包裝器的運用
/zh-TW/docs/JavaScript/Guide/Obsolete_Pages/LiveConnect_概要/資料類型的轉換	/zh-TW/docs/Web/JavaScript/Obsolete_Pages/Obsolete_Pages/Obsolete_Pages/LiveConnect_概要/資料類型的轉換
/zh-TW/docs/JavaScript/Guide/Obsolete_Pages/LiveConnect_概要/資料類型的轉換/從_JavaScript_到_Java_的轉換	/zh-TW/docs/Web/JavaScript/Obsolete_Pages/Obsolete_Pages/Obsolete_Pages/LiveConnect_概要/資料類型的轉換/從_JavaScript_到_Java_的轉換
/zh-TW/docs/JavaScript/Guide/Obsolete_Pages/LiveConnect_概要/資料類型的轉換/從_Java_到_JavaScript_的轉換	/zh-TW/docs/Web/JavaScript/Obsolete_Pages/Obsolete_Pages/Obsolete_Pages/LiveConnect_概要/資料類型的轉換/從_Java_到_JavaScript_的轉換
/zh-TW/docs/JavaScript/Guide/Obsolete_Pages/Unicode	/zh-TW/docs/Web/JavaScript/Obsolete_Pages/Obsolete_Pages/Obsolete_Pages/Unicode
/zh-TW/docs/JavaScript/Guide/Obsolete_Pages/arguments_物件的使用	/zh-TW/docs/Web/JavaScript/Reference/Functions/arguments
/zh-TW/docs/JavaScript/Guide/Obsolete_Pages/以類別為基礎的語言_vs._以原型為基礎的語言	/zh-TW/docs/Web/JavaScript/Obsolete_Pages/Obsolete_Pages/Obsolete_Pages/以類別為基礎的語言_vs._以原型為基礎的語言
/zh-TW/docs/JavaScript/Guide/Obsolete_Pages/例外處理語法	/zh-TW/docs/Web/JavaScript/Obsolete_Pages/Obsolete_Pages/Obsolete_Pages/例外處理語法
/zh-TW/docs/JavaScript/Guide/Obsolete_Pages/例外處理語法/throw_語法	/zh-TW/docs/Web/JavaScript/Obsolete_Pages/Obsolete_Pages/Obsolete_Pages/例外處理語法/throw_語法
/zh-TW/docs/JavaScript/Guide/Obsolete_Pages/例外處理語法/try...catch_語法	/zh-TW/docs/Web/JavaScript/Obsolete_Pages/Obsolete_Pages/Obsolete_Pages/例外處理語法/try...catch_語法
/zh-TW/docs/JavaScript/Guide/Obsolete_Pages/值	/zh-TW/docs/Web/JavaScript/Obsolete_Pages/Obsolete_Pages/Obsolete_Pages/值
/zh-TW/docs/JavaScript/Guide/Obsolete_Pages/再談屬性的繼承	/zh-TW/docs/Web/JavaScript/Obsolete_Pages/Obsolete_Pages/Obsolete_Pages/再談屬性的繼承
/zh-TW/docs/JavaScript/Guide/Obsolete_Pages/再談屬性的繼承/實體關係的確定	/zh-TW/docs/Web/JavaScript/Obsolete_Pages/Obsolete_Pages/Obsolete_Pages/再談屬性的繼承/實體關係的確定
/zh-TW/docs/JavaScript/Guide/Obsolete_Pages/再談屬性的繼承/局域值和繼承值	/zh-TW/docs/Web/JavaScript/Obsolete_Pages/Obsolete_Pages/Obsolete_Pages/再談屬性的繼承/局域值和繼承值
/zh-TW/docs/JavaScript/Guide/Obsolete_Pages/再談屬性的繼承/建構子中的全域資訊	/zh-TW/docs/Web/JavaScript/Obsolete_Pages/Obsolete_Pages/Obsolete_Pages/再談屬性的繼承/建構子中的全域資訊
/zh-TW/docs/JavaScript/Guide/Obsolete_Pages/再談屬性的繼承/沒有多重繼承	/zh-TW/docs/Web/JavaScript/Obsolete_Pages/Obsolete_Pages/Obsolete_Pages/再談屬性的繼承/沒有多重繼承
/zh-TW/docs/JavaScript/Guide/Obsolete_Pages/函數的呼叫	/zh-TW/docs/Web/JavaScript/Obsolete_Pages/Obsolete_Pages/Obsolete_Pages/函數的呼叫
/zh-TW/docs/JavaScript/Guide/Obsolete_Pages/函數的定義	/zh-TW/docs/Web/JavaScript/Obsolete_Pages/Obsolete_Pages/Obsolete_Pages/函數的定義
/zh-TW/docs/JavaScript/Guide/Obsolete_Pages/區塊文法	/zh-TW/docs/Web/JavaScript/Obsolete_Pages/Obsolete_Pages/Obsolete_Pages/區塊語法
/zh-TW/docs/JavaScript/Guide/Obsolete_Pages/區塊語法	/zh-TW/docs/Web/JavaScript/Obsolete_Pages/Obsolete_Pages/Obsolete_Pages/區塊語法
/zh-TW/docs/JavaScript/Guide/Obsolete_Pages/字面表達	/zh-TW/docs/Web/JavaScript/Obsolete_Pages/Obsolete_Pages/Obsolete_Pages/字面表達
/zh-TW/docs/JavaScript/Guide/Obsolete_Pages/常數	/zh-TW/docs/Web/JavaScript/Obsolete_Pages/Obsolete_Pages/Obsolete_Pages/常數
/zh-TW/docs/JavaScript/Guide/Obsolete_Pages/建立新的物件	/zh-TW/docs/Web/JavaScript/Obsolete_Pages/Obsolete_Pages/Obsolete_Pages/建立新的物件
/zh-TW/docs/JavaScript/Guide/Obsolete_Pages/建立新的物件/物件初始化子的使用	/zh-TW/docs/Web/JavaScript/Obsolete_Pages/Obsolete_Pages/Obsolete_Pages/新物件的建立/物件初始化子的使用
/zh-TW/docs/JavaScript/Guide/Obsolete_Pages/循環語法	/zh-TW/docs/Web/JavaScript/Obsolete_Pages/Obsolete_Pages/Obsolete_Pages/循環語法
/zh-TW/docs/JavaScript/Guide/Obsolete_Pages/循環語法/break_語法	/zh-TW/docs/Web/JavaScript/Obsolete_Pages/Obsolete_Pages/Obsolete_Pages/循環語法/break_語法
/zh-TW/docs/JavaScript/Guide/Obsolete_Pages/循環語法/continue_語法	/zh-TW/docs/Web/JavaScript/Obsolete_Pages/Obsolete_Pages/Obsolete_Pages/循環語法/continue_語法
/zh-TW/docs/JavaScript/Guide/Obsolete_Pages/循環語法/do...while_語法	/zh-TW/docs/Web/JavaScript/Obsolete_Pages/Obsolete_Pages/Obsolete_Pages/循環語法/do...while_語法
/zh-TW/docs/JavaScript/Guide/Obsolete_Pages/循環語法/for_語法	/zh-TW/docs/Web/JavaScript/Obsolete_Pages/Obsolete_Pages/Obsolete_Pages/循環語法/for_語法
/zh-TW/docs/JavaScript/Guide/Obsolete_Pages/循環語法/label_語法	/zh-TW/docs/Web/JavaScript/Obsolete_Pages/Obsolete_Pages/Obsolete_Pages/循環語法/label_語法
/zh-TW/docs/JavaScript/Guide/Obsolete_Pages/循環語法/while_語法	/zh-TW/docs/Web/JavaScript/Obsolete_Pages/Obsolete_Pages/Obsolete_Pages/循環語法/while_語法
/zh-TW/docs/JavaScript/Guide/Obsolete_Pages/文法	/zh-TW/docs/Core_JavaScript_1.5_教學/語法
/zh-TW/docs/JavaScript/Guide/Obsolete_Pages/新物件的建立	/zh-TW/docs/Web/JavaScript/Obsolete_Pages/Obsolete_Pages/Obsolete_Pages/新物件的建立
/zh-TW/docs/JavaScript/Guide/Obsolete_Pages/新物件的建立/Getter_和_Setter_的定義	/zh-TW/docs/Web/JavaScript/Obsolete_Pages/Obsolete_Pages/Obsolete_Pages/新物件的建立/Getter_和_Setter_的定義
/zh-TW/docs/JavaScript/Guide/Obsolete_Pages/新物件的建立/使用_this_取得物件的參考	/zh-TW/docs/Web/JavaScript/Obsolete_Pages/Obsolete_Pages/Obsolete_Pages/新物件的建立/使用_this_取得物件的參考
/zh-TW/docs/JavaScript/Guide/Obsolete_Pages/新物件的建立/屬性的刪除	/zh-TW/docs/Web/JavaScript/Obsolete_Pages/Obsolete_Pages/Obsolete_Pages/新物件的建立/屬性的刪除
/zh-TW/docs/JavaScript/Guide/Obsolete_Pages/新物件的建立/建構子函數的使用	/zh-TW/docs/Web/JavaScript/Obsolete_Pages/Obsolete_Pages/Obsolete_Pages/新物件的建立/建構子函數的使用
/zh-TW/docs/JavaScript/Guide/Obsolete_Pages/新物件的建立/方法的定義	/zh-TW/docs/Web/JavaScript/Obsolete_Pages/Obsolete_Pages/Obsolete_Pages/新物件的建立/方法的定義
/zh-TW/docs/JavaScript/Guide/Obsolete_Pages/新物件的建立/物件初始化子的使用	/zh-TW/docs/Web/JavaScript/Obsolete_Pages/Obsolete_Pages/Obsolete_Pages/新物件的建立/物件初始化子的使用
/zh-TW/docs/JavaScript/Guide/Obsolete_Pages/新物件的建立/物件屬性的索引	/zh-TW/docs/Web/JavaScript/Obsolete_Pages/Obsolete_Pages/Obsolete_Pages/新物件的建立/物件屬性的索引
/zh-TW/docs/JavaScript/Guide/Obsolete_Pages/新物件的建立/針對物件的類型定義屬性	/zh-TW/docs/Web/JavaScript/Obsolete_Pages/Obsolete_Pages/Obsolete_Pages/新物件的建立/針對物件的類型定義屬性
/zh-TW/docs/JavaScript/Guide/Obsolete_Pages/條件文法	/zh-TW/docs/Web/JavaScript/Obsolete_Pages/Obsolete_Pages/Obsolete_Pages/條件語法
/zh-TW/docs/JavaScript/Guide/Obsolete_Pages/條件語法	/zh-TW/docs/Web/JavaScript/Obsolete_Pages/Obsolete_Pages/Obsolete_Pages/條件語法
/zh-TW/docs/JavaScript/Guide/Obsolete_Pages/正則表達式	/zh-TW/docs/Core_JavaScript_1.5_教學/正規表達式
/zh-TW/docs/JavaScript/Guide/Obsolete_Pages/正則表達式模式的編寫	/zh-TW/docs/Web/JavaScript/Obsolete_Pages/Obsolete_Pages/Obsolete_Pages/正規表達式模式的編寫
/zh-TW/docs/JavaScript/Guide/Obsolete_Pages/正則表達式的建立	/zh-TW/docs/Web/JavaScript/Obsolete_Pages/Obsolete_Pages/Obsolete_Pages/正規表達式的建立
/zh-TW/docs/JavaScript/Guide/Obsolete_Pages/正則表達式的運用	/zh-TW/docs/Web/JavaScript/Obsolete_Pages/Obsolete_Pages/Obsolete_Pages/正規表達式的運用
/zh-TW/docs/JavaScript/Guide/Obsolete_Pages/正則表達式的運用/使用標誌的進階搜尋	/zh-TW/docs/Web/JavaScript/Obsolete_Pages/Obsolete_Pages/Obsolete_Pages/正規表達式的運用/使用標誌的進階搜尋
/zh-TW/docs/JavaScript/Guide/Obsolete_Pages/正則表達式的運用/括弧子字串的比對結果的運用	/zh-TW/docs/Web/JavaScript/Obsolete_Pages/Obsolete_Pages/Obsolete_Pages/正規表達式的運用/括弧子字串的比對結果的運用
/zh-TW/docs/JavaScript/Guide/Obsolete_Pages/正則表達式的運用/正則表達式的範例	/zh-TW/docs/Web/JavaScript/Obsolete_Pages/Obsolete_Pages/Obsolete_Pages/正規表達式的運用/正規表達式的範例
/zh-TW/docs/JavaScript/Guide/Obsolete_Pages/正規表達式模式的編寫	/zh-TW/docs/Web/JavaScript/Obsolete_Pages/Obsolete_Pages/Obsolete_Pages/正規表達式模式的編寫
/zh-TW/docs/JavaScript/Guide/Obsolete_Pages/正規表達式的建立	/zh-TW/docs/Web/JavaScript/Obsolete_Pages/Obsolete_Pages/Obsolete_Pages/正規表達式的建立
/zh-TW/docs/JavaScript/Guide/Obsolete_Pages/正規表達式的運用	/zh-TW/docs/Web/JavaScript/Obsolete_Pages/Obsolete_Pages/Obsolete_Pages/正規表達式的運用
/zh-TW/docs/JavaScript/Guide/Obsolete_Pages/正規表達式的運用/使用標誌的進階搜尋	/zh-TW/docs/Web/JavaScript/Obsolete_Pages/Obsolete_Pages/Obsolete_Pages/正規表達式的運用/使用標誌的進階搜尋
/zh-TW/docs/JavaScript/Guide/Obsolete_Pages/正規表達式的運用/括弧子字串的比對結果的運用	/zh-TW/docs/Web/JavaScript/Obsolete_Pages/Obsolete_Pages/Obsolete_Pages/正規表達式的運用/括弧子字串的比對結果的運用
/zh-TW/docs/JavaScript/Guide/Obsolete_Pages/正規表達式的運用/正則表達式的範例	/zh-TW/docs/Web/JavaScript/Obsolete_Pages/Obsolete_Pages/Obsolete_Pages/正規表達式的運用/正規表達式的範例
/zh-TW/docs/JavaScript/Guide/Obsolete_Pages/正規表達式的運用/正規表達式的範例	/zh-TW/docs/Web/JavaScript/Obsolete_Pages/Obsolete_Pages/Obsolete_Pages/正規表達式的運用/正規表達式的範例
/zh-TW/docs/JavaScript/Guide/Obsolete_Pages/物件和屬性	/zh-TW/docs/Web/JavaScript/Obsolete_Pages/Obsolete_Pages/Obsolete_Pages/物件和屬性
/zh-TW/docs/JavaScript/Guide/Obsolete_Pages/物件的操作語法	/zh-TW/docs/Web/JavaScript/Obsolete_Pages/Obsolete_Pages/Obsolete_Pages/物件的操作語法
/zh-TW/docs/JavaScript/Guide/Obsolete_Pages/繼承	/zh-TW/docs/Web/JavaScript/Obsolete_Pages/Obsolete_Pages/Obsolete_Pages/繼承
/zh-TW/docs/JavaScript/Guide/Obsolete_Pages/職員的例子	/zh-TW/docs/Web/JavaScript/Obsolete_Pages/Obsolete_Pages/Obsolete_Pages/職員的例子
/zh-TW/docs/JavaScript/Guide/Obsolete_Pages/職員的例子/更靈活的建構子	/zh-TW/docs/Web/JavaScript/Obsolete_Pages/Obsolete_Pages/Obsolete_Pages/職員的例子/更靈活的建構子
/zh-TW/docs/JavaScript/Guide/Obsolete_Pages/職員的例子/物件的屬性	/zh-TW/docs/Web/JavaScript/Obsolete_Pages/Obsolete_Pages/Obsolete_Pages/職員的例子/物件的屬性
/zh-TW/docs/JavaScript/Guide/Obsolete_Pages/職員的例子/物件的屬性/屬性的加入	/zh-TW/docs/Web/JavaScript/Obsolete_Pages/Obsolete_Pages/Obsolete_Pages/職員的例子/物件的屬性/屬性的加入
/zh-TW/docs/JavaScript/Guide/Obsolete_Pages/職員的例子/物件的屬性/屬性的繼承	/zh-TW/docs/Web/JavaScript/Obsolete_Pages/Obsolete_Pages/Obsolete_Pages/職員的例子/物件的屬性/屬性的繼承
/zh-TW/docs/JavaScript/Guide/Obsolete_Pages/職員的例子/階層的建立	/zh-TW/docs/Web/JavaScript/Obsolete_Pages/Obsolete_Pages/Obsolete_Pages/職員的例子/階層的建立
/zh-TW/docs/JavaScript/Guide/Obsolete_Pages/表達式	/zh-TW/docs/Web/JavaScript/Obsolete_Pages/Obsolete_Pages/Obsolete_Pages/表達式
/zh-TW/docs/JavaScript/Guide/Obsolete_Pages/註解	/zh-TW/docs/Web/JavaScript/Obsolete_Pages/Obsolete_Pages/Obsolete_Pages/註解
/zh-TW/docs/JavaScript/Guide/Obsolete_Pages/變數	/zh-TW/docs/Web/JavaScript/Obsolete_Pages/Obsolete_Pages/Obsolete_Pages/變數
/zh-TW/docs/JavaScript/Guide/Obsolete_Pages/迭代器和產生器	/zh-TW/docs/Web/JavaScript/Obsolete_Pages/Obsolete_Pages/Obsolete_Pages/迭代器和產生器
/zh-TW/docs/JavaScript/Guide/Obsolete_Pages/運算子	/zh-TW/docs/Web/JavaScript/Obsolete_Pages/Obsolete_Pages/Obsolete_Pages/運算子
/zh-TW/docs/JavaScript/Guide/Obsolete_Pages/運算子/代入運算子	/zh-TW/docs/Web/JavaScript/Obsolete_Pages/Obsolete_Pages/Obsolete_Pages/運算子/代入運算子
/zh-TW/docs/JavaScript/Guide/Obsolete_Pages/運算子/位元運算子	/zh-TW/docs/Web/JavaScript/Obsolete_Pages/Obsolete_Pages/Obsolete_Pages/運算子/位元運算子
/zh-TW/docs/JavaScript/Guide/Obsolete_Pages/運算子/字串運算子	/zh-TW/docs/Web/JavaScript/Obsolete_Pages/Obsolete_Pages/Obsolete_Pages/運算子/字串運算子
/zh-TW/docs/JavaScript/Guide/Obsolete_Pages/運算子/比較運算子	/zh-TW/docs/Web/JavaScript/Obsolete_Pages/Obsolete_Pages/Obsolete_Pages/運算子/比較運算子
/zh-TW/docs/JavaScript/Guide/Obsolete_Pages/運算子/特殊運算子	/zh-TW/docs/Web/JavaScript/Obsolete_Pages/Obsolete_Pages/Obsolete_Pages/運算子/特殊運算子
/zh-TW/docs/JavaScript/Guide/Obsolete_Pages/運算子/算術運算子	/zh-TW/docs/Web/JavaScript/Obsolete_Pages/Obsolete_Pages/Obsolete_Pages/運算子/算術運算子
/zh-TW/docs/JavaScript/Guide/Obsolete_Pages/運算子/邏輯運算子	/zh-TW/docs/Web/JavaScript/Obsolete_Pages/Obsolete_Pages/Obsolete_Pages/運算子/邏輯運算子
/zh-TW/docs/JavaScript/Guide/Obsolete_Pages/閉包的運用	/zh-TW/docs/Web/JavaScript/Obsolete_Pages/Obsolete_Pages/Obsolete_Pages/閉包的運用
/zh-TW/docs/JavaScript/Guide/Obsolete_Pages/關於	/zh-TW/docs/Web/JavaScript/Obsolete_Pages/Obsolete_Pages/Obsolete_Pages/關於
/zh-TW/docs/JavaScript/Guide/Obsolete_Pages/陣列的運用	/zh-TW/docs/Web/JavaScript/Obsolete_Pages/Obsolete_Pages/Obsolete_Pages/陣列的運用
/zh-TW/docs/JavaScript/Guide/Obsolete_Pages/預先定義的函數	/zh-TW/docs/Web/JavaScript/Obsolete_Pages/Obsolete_Pages/Obsolete_Pages/預先定義的函數
/zh-TW/docs/JavaScript/Guide/Obsolete_Pages/預先定義的函數/Number_和_String_函數	/zh-TW/docs/Web/JavaScript/Obsolete_Pages/Obsolete_Pages/Obsolete_Pages/預先定義的函數/Number_和_String_函數
/zh-TW/docs/JavaScript/Guide/Obsolete_Pages/預先定義的函數/escape_和_unescape_函數	/zh-TW/docs/Web/JavaScript/Obsolete_Pages/Obsolete_Pages/Obsolete_Pages/預先定義的函數/escape_和_unescape_函數
/zh-TW/docs/JavaScript/Guide/Obsolete_Pages/預先定義的函數/eval_函數	/zh-TW/docs/Web/JavaScript/Obsolete_Pages/Obsolete_Pages/Obsolete_Pages/預先定義的函數/eval_函數
/zh-TW/docs/JavaScript/Guide/Obsolete_Pages/預先定義的函數/isFinite_函數	/zh-TW/docs/Web/JavaScript/Obsolete_Pages/Obsolete_Pages/Obsolete_Pages/預先定義的函數/isFinite_函數
/zh-TW/docs/JavaScript/Guide/Obsolete_Pages/預先定義的函數/isNaN_函數	/zh-TW/docs/Web/JavaScript/Obsolete_Pages/Obsolete_Pages/Obsolete_Pages/預先定義的函數/isNaN_函數
/zh-TW/docs/JavaScript/Guide/Obsolete_Pages/預先定義的函數/parseInt_和_parseFloat_函數	/zh-TW/docs/Web/JavaScript/Obsolete_Pages/Obsolete_Pages/Obsolete_Pages/預先定義的函數/parseInt_和_parseFloat_函數
/zh-TW/docs/JavaScript/Guide/Obsolete_Pages/預先定義的核心物件	/zh-TW/docs/Web/JavaScript/Obsolete_Pages/Obsolete_Pages/Obsolete_Pages/預先定義的核心物件
/zh-TW/docs/JavaScript/Guide/Obsolete_Pages/預先定義的核心物件/Array_物件	/zh-TW/docs/Web/JavaScript/Obsolete_Pages/Obsolete_Pages/Obsolete_Pages/預先定義的核心物件/Array_物件
/zh-TW/docs/JavaScript/Guide/Obsolete_Pages/預先定義的核心物件/Boolean_物件	/zh-TW/docs/Web/JavaScript/Obsolete_Pages/Obsolete_Pages/Obsolete_Pages/預先定義的核心物件/Boolean_物件
/zh-TW/docs/JavaScript/Guide/Obsolete_Pages/預先定義的核心物件/Date_物件	/zh-TW/docs/Web/JavaScript/Obsolete_Pages/Obsolete_Pages/Obsolete_Pages/預先定義的核心物件/Date_物件
/zh-TW/docs/JavaScript/Guide/Obsolete_Pages/預先定義的核心物件/Function_物件	/zh-TW/docs/Web/JavaScript/Obsolete_Pages/Obsolete_Pages/Obsolete_Pages/預先定義的核心物件/Function_物件
/zh-TW/docs/JavaScript/Guide/Obsolete_Pages/預先定義的核心物件/Math_物件	/zh-TW/docs/Web/JavaScript/Obsolete_Pages/Obsolete_Pages/Obsolete_Pages/預先定義的核心物件/Math_物件
/zh-TW/docs/JavaScript/Guide/Obsolete_Pages/預先定義的核心物件/Number_物件	/zh-TW/docs/Web/JavaScript/Obsolete_Pages/Obsolete_Pages/Obsolete_Pages/預先定義的核心物件/Number_物件
/zh-TW/docs/JavaScript/Guide/Obsolete_Pages/預先定義的核心物件/RegExp_物件	/zh-TW/docs/Web/JavaScript/Obsolete_Pages/Obsolete_Pages/Obsolete_Pages/預先定義的核心物件/RegExp_物件
/zh-TW/docs/JavaScript/Guide/Obsolete_Pages/預先定義的核心物件/String_物件	/zh-TW/docs/Web/JavaScript/Obsolete_Pages/Obsolete_Pages/Obsolete_Pages/預先定義的核心物件/String_物件
/zh-TW/docs/JavaScript/Guide/Regular_Expressions	/zh-TW/docs/Web/JavaScript/Guide/Regular_Expressions
/zh-TW/docs/JavaScript/Guide/Values,_variables,_and_literals	/zh-TW/docs/Web/JavaScript/Guide/Grammar_and_types
/zh-TW/docs/JavaScript/Guide/Working_with_Objects	/zh-TW/docs/Web/JavaScript/Guide/Working_with_Objects
/zh-TW/docs/JavaScript/New_in_JavaScript	/zh-TW/docs/Web/JavaScript/New_in_JavaScript
/zh-TW/docs/JavaScript/New_in_JavaScript/JavaScript_1.6_新鮮事	/zh-TW/docs/Web/JavaScript/New_in_JavaScript/1.6
/zh-TW/docs/JavaScript/New_in_JavaScript/JavaScript_1.7_新鮮事	/zh-TW/docs/Web/JavaScript/New_in_JavaScript/1.7
/zh-TW/docs/JavaScript/Obsolete_Pages	/zh-TW/docs/Web/JavaScript/Obsolete_Pages
/zh-TW/docs/JavaScript/Obsolete_Pages/Obsolete_Pages	/zh-TW/docs/Web/JavaScript/Guide
/zh-TW/docs/JavaScript/Obsolete_Pages/Obsolete_Pages/Obsolete_Pages	/zh-TW/docs/Web/JavaScript/Guide
/zh-TW/docs/JavaScript/Obsolete_Pages/Obsolete_Pages/Obsolete_Pages/JavaScript_概要	/zh-TW/docs/Web/JavaScript/Obsolete_Pages/Obsolete_Pages/Obsolete_Pages/JavaScript_概要
/zh-TW/docs/JavaScript/Obsolete_Pages/Obsolete_Pages/Obsolete_Pages/LiveConnect_概要	/zh-TW/docs/Web/JavaScript/Obsolete_Pages/Obsolete_Pages/Obsolete_Pages/LiveConnect_概要
/zh-TW/docs/JavaScript/Obsolete_Pages/Obsolete_Pages/Obsolete_Pages/LiveConnect_概要/JavaScript_向_Java_的通訊	/zh-TW/docs/Web/JavaScript/Obsolete_Pages/Obsolete_Pages/Obsolete_Pages/LiveConnect_概要/JavaScript_向_Java_的通訊
/zh-TW/docs/JavaScript/Obsolete_Pages/Obsolete_Pages/Obsolete_Pages/LiveConnect_概要/Java_向_JavaScript_的通訊	/zh-TW/docs/Web/JavaScript/Obsolete_Pages/Obsolete_Pages/Obsolete_Pages/LiveConnect_概要/Java_向_JavaScript_的通訊
/zh-TW/docs/JavaScript/Obsolete_Pages/Obsolete_Pages/Obsolete_Pages/LiveConnect_概要/Java_向_JavaScript_的通訊/LiveConnect_類別的使用	/zh-TW/docs/Web/JavaScript/Obsolete_Pages/Obsolete_Pages/Obsolete_Pages/LiveConnect_概要/Java_向_JavaScript_的通訊/LiveConnect_類別的使用
/zh-TW/docs/JavaScript/Obsolete_Pages/Obsolete_Pages/Obsolete_Pages/LiveConnect_概要/包裝器的運用	/zh-TW/docs/Web/JavaScript/Obsolete_Pages/Obsolete_Pages/Obsolete_Pages/LiveConnect_概要/包裝器的運用
/zh-TW/docs/JavaScript/Obsolete_Pages/Obsolete_Pages/Obsolete_Pages/LiveConnect_概要/資料類型的轉換	/zh-TW/docs/Web/JavaScript/Obsolete_Pages/Obsolete_Pages/Obsolete_Pages/LiveConnect_概要/資料類型的轉換
/zh-TW/docs/JavaScript/Obsolete_Pages/Obsolete_Pages/Obsolete_Pages/LiveConnect_概要/資料類型的轉換/從_JavaScript_到_Java_的轉換	/zh-TW/docs/Web/JavaScript/Obsolete_Pages/Obsolete_Pages/Obsolete_Pages/LiveConnect_概要/資料類型的轉換/從_JavaScript_到_Java_的轉換
/zh-TW/docs/JavaScript/Obsolete_Pages/Obsolete_Pages/Obsolete_Pages/LiveConnect_概要/資料類型的轉換/從_Java_到_JavaScript_的轉換	/zh-TW/docs/Web/JavaScript/Obsolete_Pages/Obsolete_Pages/Obsolete_Pages/LiveConnect_概要/資料類型的轉換/從_Java_到_JavaScript_的轉換
/zh-TW/docs/JavaScript/Obsolete_Pages/Obsolete_Pages/Obsolete_Pages/Unicode	/zh-TW/docs/Web/JavaScript/Obsolete_Pages/Obsolete_Pages/Obsolete_Pages/Unicode
/zh-TW/docs/JavaScript/Obsolete_Pages/Obsolete_Pages/Obsolete_Pages/arguments_物件的使用	/zh-TW/docs/Web/JavaScript/Reference/Functions/arguments
/zh-TW/docs/JavaScript/Obsolete_Pages/Obsolete_Pages/Obsolete_Pages/以類別為基礎的語言_vs._以原型為基礎的語言	/zh-TW/docs/Web/JavaScript/Obsolete_Pages/Obsolete_Pages/Obsolete_Pages/以類別為基礎的語言_vs._以原型為基礎的語言
/zh-TW/docs/JavaScript/Obsolete_Pages/Obsolete_Pages/Obsolete_Pages/例外處理語法	/zh-TW/docs/Web/JavaScript/Obsolete_Pages/Obsolete_Pages/Obsolete_Pages/例外處理語法
/zh-TW/docs/JavaScript/Obsolete_Pages/Obsolete_Pages/Obsolete_Pages/例外處理語法/throw_語法	/zh-TW/docs/Web/JavaScript/Obsolete_Pages/Obsolete_Pages/Obsolete_Pages/例外處理語法/throw_語法
/zh-TW/docs/JavaScript/Obsolete_Pages/Obsolete_Pages/Obsolete_Pages/例外處理語法/try...catch_語法	/zh-TW/docs/Web/JavaScript/Obsolete_Pages/Obsolete_Pages/Obsolete_Pages/例外處理語法/try...catch_語法
/zh-TW/docs/JavaScript/Obsolete_Pages/Obsolete_Pages/Obsolete_Pages/值	/zh-TW/docs/Web/JavaScript/Obsolete_Pages/Obsolete_Pages/Obsolete_Pages/值
/zh-TW/docs/JavaScript/Obsolete_Pages/Obsolete_Pages/Obsolete_Pages/再談屬性的繼承	/zh-TW/docs/Web/JavaScript/Obsolete_Pages/Obsolete_Pages/Obsolete_Pages/再談屬性的繼承
/zh-TW/docs/JavaScript/Obsolete_Pages/Obsolete_Pages/Obsolete_Pages/再談屬性的繼承/實體關係的確定	/zh-TW/docs/Web/JavaScript/Obsolete_Pages/Obsolete_Pages/Obsolete_Pages/再談屬性的繼承/實體關係的確定
/zh-TW/docs/JavaScript/Obsolete_Pages/Obsolete_Pages/Obsolete_Pages/再談屬性的繼承/局域值和繼承值	/zh-TW/docs/Web/JavaScript/Obsolete_Pages/Obsolete_Pages/Obsolete_Pages/再談屬性的繼承/局域值和繼承值
/zh-TW/docs/JavaScript/Obsolete_Pages/Obsolete_Pages/Obsolete_Pages/再談屬性的繼承/建構子中的全域資訊	/zh-TW/docs/Web/JavaScript/Obsolete_Pages/Obsolete_Pages/Obsolete_Pages/再談屬性的繼承/建構子中的全域資訊
/zh-TW/docs/JavaScript/Obsolete_Pages/Obsolete_Pages/Obsolete_Pages/再談屬性的繼承/沒有多重繼承	/zh-TW/docs/Web/JavaScript/Obsolete_Pages/Obsolete_Pages/Obsolete_Pages/再談屬性的繼承/沒有多重繼承
/zh-TW/docs/JavaScript/Obsolete_Pages/Obsolete_Pages/Obsolete_Pages/函數的呼叫	/zh-TW/docs/Web/JavaScript/Obsolete_Pages/Obsolete_Pages/Obsolete_Pages/函數的呼叫
/zh-TW/docs/JavaScript/Obsolete_Pages/Obsolete_Pages/Obsolete_Pages/函數的定義	/zh-TW/docs/Web/JavaScript/Obsolete_Pages/Obsolete_Pages/Obsolete_Pages/函數的定義
/zh-TW/docs/JavaScript/Obsolete_Pages/Obsolete_Pages/Obsolete_Pages/區塊文法	/zh-TW/docs/Web/JavaScript/Obsolete_Pages/Obsolete_Pages/Obsolete_Pages/區塊語法
/zh-TW/docs/JavaScript/Obsolete_Pages/Obsolete_Pages/Obsolete_Pages/區塊語法	/zh-TW/docs/Web/JavaScript/Obsolete_Pages/Obsolete_Pages/Obsolete_Pages/區塊語法
/zh-TW/docs/JavaScript/Obsolete_Pages/Obsolete_Pages/Obsolete_Pages/字面表達	/zh-TW/docs/Web/JavaScript/Obsolete_Pages/Obsolete_Pages/Obsolete_Pages/字面表達
/zh-TW/docs/JavaScript/Obsolete_Pages/Obsolete_Pages/Obsolete_Pages/常數	/zh-TW/docs/Web/JavaScript/Obsolete_Pages/Obsolete_Pages/Obsolete_Pages/常數
/zh-TW/docs/JavaScript/Obsolete_Pages/Obsolete_Pages/Obsolete_Pages/建立新的物件	/zh-TW/docs/Web/JavaScript/Obsolete_Pages/Obsolete_Pages/Obsolete_Pages/建立新的物件
/zh-TW/docs/JavaScript/Obsolete_Pages/Obsolete_Pages/Obsolete_Pages/建立新的物件/物件初始化子的使用	/zh-TW/docs/Web/JavaScript/Obsolete_Pages/Obsolete_Pages/Obsolete_Pages/新物件的建立/物件初始化子的使用
/zh-TW/docs/JavaScript/Obsolete_Pages/Obsolete_Pages/Obsolete_Pages/循環語法	/zh-TW/docs/Web/JavaScript/Obsolete_Pages/Obsolete_Pages/Obsolete_Pages/循環語法
/zh-TW/docs/JavaScript/Obsolete_Pages/Obsolete_Pages/Obsolete_Pages/循環語法/break_語法	/zh-TW/docs/Web/JavaScript/Obsolete_Pages/Obsolete_Pages/Obsolete_Pages/循環語法/break_語法
/zh-TW/docs/JavaScript/Obsolete_Pages/Obsolete_Pages/Obsolete_Pages/循環語法/continue_語法	/zh-TW/docs/Web/JavaScript/Obsolete_Pages/Obsolete_Pages/Obsolete_Pages/循環語法/continue_語法
/zh-TW/docs/JavaScript/Obsolete_Pages/Obsolete_Pages/Obsolete_Pages/循環語法/do...while_語法	/zh-TW/docs/Web/JavaScript/Obsolete_Pages/Obsolete_Pages/Obsolete_Pages/循環語法/do...while_語法
/zh-TW/docs/JavaScript/Obsolete_Pages/Obsolete_Pages/Obsolete_Pages/循環語法/for_語法	/zh-TW/docs/Web/JavaScript/Obsolete_Pages/Obsolete_Pages/Obsolete_Pages/循環語法/for_語法
/zh-TW/docs/JavaScript/Obsolete_Pages/Obsolete_Pages/Obsolete_Pages/循環語法/label_語法	/zh-TW/docs/Web/JavaScript/Obsolete_Pages/Obsolete_Pages/Obsolete_Pages/循環語法/label_語法
/zh-TW/docs/JavaScript/Obsolete_Pages/Obsolete_Pages/Obsolete_Pages/循環語法/while_語法	/zh-TW/docs/Web/JavaScript/Obsolete_Pages/Obsolete_Pages/Obsolete_Pages/循環語法/while_語法
/zh-TW/docs/JavaScript/Obsolete_Pages/Obsolete_Pages/Obsolete_Pages/文法	/zh-TW/docs/Core_JavaScript_1.5_教學/語法
/zh-TW/docs/JavaScript/Obsolete_Pages/Obsolete_Pages/Obsolete_Pages/新物件的建立	/zh-TW/docs/Web/JavaScript/Obsolete_Pages/Obsolete_Pages/Obsolete_Pages/新物件的建立
/zh-TW/docs/JavaScript/Obsolete_Pages/Obsolete_Pages/Obsolete_Pages/新物件的建立/Getter_和_Setter_的定義	/zh-TW/docs/Web/JavaScript/Obsolete_Pages/Obsolete_Pages/Obsolete_Pages/新物件的建立/Getter_和_Setter_的定義
/zh-TW/docs/JavaScript/Obsolete_Pages/Obsolete_Pages/Obsolete_Pages/新物件的建立/使用_this_取得物件的參考	/zh-TW/docs/Web/JavaScript/Obsolete_Pages/Obsolete_Pages/Obsolete_Pages/新物件的建立/使用_this_取得物件的參考
/zh-TW/docs/JavaScript/Obsolete_Pages/Obsolete_Pages/Obsolete_Pages/新物件的建立/屬性的刪除	/zh-TW/docs/Web/JavaScript/Obsolete_Pages/Obsolete_Pages/Obsolete_Pages/新物件的建立/屬性的刪除
/zh-TW/docs/JavaScript/Obsolete_Pages/Obsolete_Pages/Obsolete_Pages/新物件的建立/建構子函數的使用	/zh-TW/docs/Web/JavaScript/Obsolete_Pages/Obsolete_Pages/Obsolete_Pages/新物件的建立/建構子函數的使用
/zh-TW/docs/JavaScript/Obsolete_Pages/Obsolete_Pages/Obsolete_Pages/新物件的建立/方法的定義	/zh-TW/docs/Web/JavaScript/Obsolete_Pages/Obsolete_Pages/Obsolete_Pages/新物件的建立/方法的定義
/zh-TW/docs/JavaScript/Obsolete_Pages/Obsolete_Pages/Obsolete_Pages/新物件的建立/物件初始化子的使用	/zh-TW/docs/Web/JavaScript/Obsolete_Pages/Obsolete_Pages/Obsolete_Pages/新物件的建立/物件初始化子的使用
/zh-TW/docs/JavaScript/Obsolete_Pages/Obsolete_Pages/Obsolete_Pages/新物件的建立/物件屬性的索引	/zh-TW/docs/Web/JavaScript/Obsolete_Pages/Obsolete_Pages/Obsolete_Pages/新物件的建立/物件屬性的索引
/zh-TW/docs/JavaScript/Obsolete_Pages/Obsolete_Pages/Obsolete_Pages/新物件的建立/針對物件的類型定義屬性	/zh-TW/docs/Web/JavaScript/Obsolete_Pages/Obsolete_Pages/Obsolete_Pages/新物件的建立/針對物件的類型定義屬性
/zh-TW/docs/JavaScript/Obsolete_Pages/Obsolete_Pages/Obsolete_Pages/條件文法	/zh-TW/docs/Web/JavaScript/Obsolete_Pages/Obsolete_Pages/Obsolete_Pages/條件語法
/zh-TW/docs/JavaScript/Obsolete_Pages/Obsolete_Pages/Obsolete_Pages/條件語法	/zh-TW/docs/Web/JavaScript/Obsolete_Pages/Obsolete_Pages/Obsolete_Pages/條件語法
/zh-TW/docs/JavaScript/Obsolete_Pages/Obsolete_Pages/Obsolete_Pages/正則表達式	/zh-TW/docs/Core_JavaScript_1.5_教學/正規表達式
/zh-TW/docs/JavaScript/Obsolete_Pages/Obsolete_Pages/Obsolete_Pages/正則表達式模式的編寫	/zh-TW/docs/Web/JavaScript/Obsolete_Pages/Obsolete_Pages/Obsolete_Pages/正規表達式模式的編寫
/zh-TW/docs/JavaScript/Obsolete_Pages/Obsolete_Pages/Obsolete_Pages/正則表達式的建立	/zh-TW/docs/Web/JavaScript/Obsolete_Pages/Obsolete_Pages/Obsolete_Pages/正規表達式的建立
/zh-TW/docs/JavaScript/Obsolete_Pages/Obsolete_Pages/Obsolete_Pages/正則表達式的運用	/zh-TW/docs/Web/JavaScript/Obsolete_Pages/Obsolete_Pages/Obsolete_Pages/正規表達式的運用
/zh-TW/docs/JavaScript/Obsolete_Pages/Obsolete_Pages/Obsolete_Pages/正則表達式的運用/使用標誌的進階搜尋	/zh-TW/docs/Web/JavaScript/Obsolete_Pages/Obsolete_Pages/Obsolete_Pages/正規表達式的運用/使用標誌的進階搜尋
/zh-TW/docs/JavaScript/Obsolete_Pages/Obsolete_Pages/Obsolete_Pages/正則表達式的運用/括弧子字串的比對結果的運用	/zh-TW/docs/Web/JavaScript/Obsolete_Pages/Obsolete_Pages/Obsolete_Pages/正規表達式的運用/括弧子字串的比對結果的運用
/zh-TW/docs/JavaScript/Obsolete_Pages/Obsolete_Pages/Obsolete_Pages/正則表達式的運用/正則表達式的範例	/zh-TW/docs/Web/JavaScript/Obsolete_Pages/Obsolete_Pages/Obsolete_Pages/正規表達式的運用/正規表達式的範例
/zh-TW/docs/JavaScript/Obsolete_Pages/Obsolete_Pages/Obsolete_Pages/正規表達式模式的編寫	/zh-TW/docs/Web/JavaScript/Obsolete_Pages/Obsolete_Pages/Obsolete_Pages/正規表達式模式的編寫
/zh-TW/docs/JavaScript/Obsolete_Pages/Obsolete_Pages/Obsolete_Pages/正規表達式的建立	/zh-TW/docs/Web/JavaScript/Obsolete_Pages/Obsolete_Pages/Obsolete_Pages/正規表達式的建立
/zh-TW/docs/JavaScript/Obsolete_Pages/Obsolete_Pages/Obsolete_Pages/正規表達式的運用	/zh-TW/docs/Web/JavaScript/Obsolete_Pages/Obsolete_Pages/Obsolete_Pages/正規表達式的運用
/zh-TW/docs/JavaScript/Obsolete_Pages/Obsolete_Pages/Obsolete_Pages/正規表達式的運用/使用標誌的進階搜尋	/zh-TW/docs/Web/JavaScript/Obsolete_Pages/Obsolete_Pages/Obsolete_Pages/正規表達式的運用/使用標誌的進階搜尋
/zh-TW/docs/JavaScript/Obsolete_Pages/Obsolete_Pages/Obsolete_Pages/正規表達式的運用/括弧子字串的比對結果的運用	/zh-TW/docs/Web/JavaScript/Obsolete_Pages/Obsolete_Pages/Obsolete_Pages/正規表達式的運用/括弧子字串的比對結果的運用
/zh-TW/docs/JavaScript/Obsolete_Pages/Obsolete_Pages/Obsolete_Pages/正規表達式的運用/正則表達式的範例	/zh-TW/docs/Web/JavaScript/Obsolete_Pages/Obsolete_Pages/Obsolete_Pages/正規表達式的運用/正規表達式的範例
/zh-TW/docs/JavaScript/Obsolete_Pages/Obsolete_Pages/Obsolete_Pages/正規表達式的運用/正規表達式的範例	/zh-TW/docs/Web/JavaScript/Obsolete_Pages/Obsolete_Pages/Obsolete_Pages/正規表達式的運用/正規表達式的範例
/zh-TW/docs/JavaScript/Obsolete_Pages/Obsolete_Pages/Obsolete_Pages/物件和屬性	/zh-TW/docs/Web/JavaScript/Obsolete_Pages/Obsolete_Pages/Obsolete_Pages/物件和屬性
/zh-TW/docs/JavaScript/Obsolete_Pages/Obsolete_Pages/Obsolete_Pages/物件的操作語法	/zh-TW/docs/Web/JavaScript/Obsolete_Pages/Obsolete_Pages/Obsolete_Pages/物件的操作語法
/zh-TW/docs/JavaScript/Obsolete_Pages/Obsolete_Pages/Obsolete_Pages/繼承	/zh-TW/docs/Web/JavaScript/Obsolete_Pages/Obsolete_Pages/Obsolete_Pages/繼承
/zh-TW/docs/JavaScript/Obsolete_Pages/Obsolete_Pages/Obsolete_Pages/職員的例子	/zh-TW/docs/Web/JavaScript/Obsolete_Pages/Obsolete_Pages/Obsolete_Pages/職員的例子
/zh-TW/docs/JavaScript/Obsolete_Pages/Obsolete_Pages/Obsolete_Pages/職員的例子/更靈活的建構子	/zh-TW/docs/Web/JavaScript/Obsolete_Pages/Obsolete_Pages/Obsolete_Pages/職員的例子/更靈活的建構子
/zh-TW/docs/JavaScript/Obsolete_Pages/Obsolete_Pages/Obsolete_Pages/職員的例子/物件的屬性	/zh-TW/docs/Web/JavaScript/Obsolete_Pages/Obsolete_Pages/Obsolete_Pages/職員的例子/物件的屬性
/zh-TW/docs/JavaScript/Obsolete_Pages/Obsolete_Pages/Obsolete_Pages/職員的例子/物件的屬性/屬性的加入	/zh-TW/docs/Web/JavaScript/Obsolete_Pages/Obsolete_Pages/Obsolete_Pages/職員的例子/物件的屬性/屬性的加入
/zh-TW/docs/JavaScript/Obsolete_Pages/Obsolete_Pages/Obsolete_Pages/職員的例子/物件的屬性/屬性的繼承	/zh-TW/docs/Web/JavaScript/Obsolete_Pages/Obsolete_Pages/Obsolete_Pages/職員的例子/物件的屬性/屬性的繼承
/zh-TW/docs/JavaScript/Obsolete_Pages/Obsolete_Pages/Obsolete_Pages/職員的例子/階層的建立	/zh-TW/docs/Web/JavaScript/Obsolete_Pages/Obsolete_Pages/Obsolete_Pages/職員的例子/階層的建立
/zh-TW/docs/JavaScript/Obsolete_Pages/Obsolete_Pages/Obsolete_Pages/表達式	/zh-TW/docs/Web/JavaScript/Obsolete_Pages/Obsolete_Pages/Obsolete_Pages/表達式
/zh-TW/docs/JavaScript/Obsolete_Pages/Obsolete_Pages/Obsolete_Pages/註解	/zh-TW/docs/Web/JavaScript/Obsolete_Pages/Obsolete_Pages/Obsolete_Pages/註解
/zh-TW/docs/JavaScript/Obsolete_Pages/Obsolete_Pages/Obsolete_Pages/變數	/zh-TW/docs/Web/JavaScript/Obsolete_Pages/Obsolete_Pages/Obsolete_Pages/變數
/zh-TW/docs/JavaScript/Obsolete_Pages/Obsolete_Pages/Obsolete_Pages/迭代器和產生器	/zh-TW/docs/Web/JavaScript/Obsolete_Pages/Obsolete_Pages/Obsolete_Pages/迭代器和產生器
/zh-TW/docs/JavaScript/Obsolete_Pages/Obsolete_Pages/Obsolete_Pages/運算子	/zh-TW/docs/Web/JavaScript/Obsolete_Pages/Obsolete_Pages/Obsolete_Pages/運算子
/zh-TW/docs/JavaScript/Obsolete_Pages/Obsolete_Pages/Obsolete_Pages/運算子/代入運算子	/zh-TW/docs/Web/JavaScript/Obsolete_Pages/Obsolete_Pages/Obsolete_Pages/運算子/代入運算子
/zh-TW/docs/JavaScript/Obsolete_Pages/Obsolete_Pages/Obsolete_Pages/運算子/位元運算子	/zh-TW/docs/Web/JavaScript/Obsolete_Pages/Obsolete_Pages/Obsolete_Pages/運算子/位元運算子
/zh-TW/docs/JavaScript/Obsolete_Pages/Obsolete_Pages/Obsolete_Pages/運算子/字串運算子	/zh-TW/docs/Web/JavaScript/Obsolete_Pages/Obsolete_Pages/Obsolete_Pages/運算子/字串運算子
/zh-TW/docs/JavaScript/Obsolete_Pages/Obsolete_Pages/Obsolete_Pages/運算子/比較運算子	/zh-TW/docs/Web/JavaScript/Obsolete_Pages/Obsolete_Pages/Obsolete_Pages/運算子/比較運算子
/zh-TW/docs/JavaScript/Obsolete_Pages/Obsolete_Pages/Obsolete_Pages/運算子/特殊運算子	/zh-TW/docs/Web/JavaScript/Obsolete_Pages/Obsolete_Pages/Obsolete_Pages/運算子/特殊運算子
/zh-TW/docs/JavaScript/Obsolete_Pages/Obsolete_Pages/Obsolete_Pages/運算子/算術運算子	/zh-TW/docs/Web/JavaScript/Obsolete_Pages/Obsolete_Pages/Obsolete_Pages/運算子/算術運算子
/zh-TW/docs/JavaScript/Obsolete_Pages/Obsolete_Pages/Obsolete_Pages/運算子/邏輯運算子	/zh-TW/docs/Web/JavaScript/Obsolete_Pages/Obsolete_Pages/Obsolete_Pages/運算子/邏輯運算子
/zh-TW/docs/JavaScript/Obsolete_Pages/Obsolete_Pages/Obsolete_Pages/閉包的運用	/zh-TW/docs/Web/JavaScript/Obsolete_Pages/Obsolete_Pages/Obsolete_Pages/閉包的運用
/zh-TW/docs/JavaScript/Obsolete_Pages/Obsolete_Pages/Obsolete_Pages/關於	/zh-TW/docs/Web/JavaScript/Obsolete_Pages/Obsolete_Pages/Obsolete_Pages/關於
/zh-TW/docs/JavaScript/Obsolete_Pages/Obsolete_Pages/Obsolete_Pages/陣列的運用	/zh-TW/docs/Web/JavaScript/Obsolete_Pages/Obsolete_Pages/Obsolete_Pages/陣列的運用
/zh-TW/docs/JavaScript/Obsolete_Pages/Obsolete_Pages/Obsolete_Pages/預先定義的函數	/zh-TW/docs/Web/JavaScript/Obsolete_Pages/Obsolete_Pages/Obsolete_Pages/預先定義的函數
/zh-TW/docs/JavaScript/Obsolete_Pages/Obsolete_Pages/Obsolete_Pages/預先定義的函數/Number_和_String_函數	/zh-TW/docs/Web/JavaScript/Obsolete_Pages/Obsolete_Pages/Obsolete_Pages/預先定義的函數/Number_和_String_函數
/zh-TW/docs/JavaScript/Obsolete_Pages/Obsolete_Pages/Obsolete_Pages/預先定義的函數/escape_和_unescape_函數	/zh-TW/docs/Web/JavaScript/Obsolete_Pages/Obsolete_Pages/Obsolete_Pages/預先定義的函數/escape_和_unescape_函數
/zh-TW/docs/JavaScript/Obsolete_Pages/Obsolete_Pages/Obsolete_Pages/預先定義的函數/eval_函數	/zh-TW/docs/Web/JavaScript/Obsolete_Pages/Obsolete_Pages/Obsolete_Pages/預先定義的函數/eval_函數
/zh-TW/docs/JavaScript/Obsolete_Pages/Obsolete_Pages/Obsolete_Pages/預先定義的函數/isFinite_函數	/zh-TW/docs/Web/JavaScript/Obsolete_Pages/Obsolete_Pages/Obsolete_Pages/預先定義的函數/isFinite_函數
/zh-TW/docs/JavaScript/Obsolete_Pages/Obsolete_Pages/Obsolete_Pages/預先定義的函數/isNaN_函數	/zh-TW/docs/Web/JavaScript/Obsolete_Pages/Obsolete_Pages/Obsolete_Pages/預先定義的函數/isNaN_函數
/zh-TW/docs/JavaScript/Obsolete_Pages/Obsolete_Pages/Obsolete_Pages/預先定義的函數/parseInt_和_parseFloat_函數	/zh-TW/docs/Web/JavaScript/Obsolete_Pages/Obsolete_Pages/Obsolete_Pages/預先定義的函數/parseInt_和_parseFloat_函數
/zh-TW/docs/JavaScript/Obsolete_Pages/Obsolete_Pages/Obsolete_Pages/預先定義的核心物件	/zh-TW/docs/Web/JavaScript/Obsolete_Pages/Obsolete_Pages/Obsolete_Pages/預先定義的核心物件
/zh-TW/docs/JavaScript/Obsolete_Pages/Obsolete_Pages/Obsolete_Pages/預先定義的核心物件/Array_物件	/zh-TW/docs/Web/JavaScript/Obsolete_Pages/Obsolete_Pages/Obsolete_Pages/預先定義的核心物件/Array_物件
/zh-TW/docs/JavaScript/Obsolete_Pages/Obsolete_Pages/Obsolete_Pages/預先定義的核心物件/Boolean_物件	/zh-TW/docs/Web/JavaScript/Obsolete_Pages/Obsolete_Pages/Obsolete_Pages/預先定義的核心物件/Boolean_物件
/zh-TW/docs/JavaScript/Obsolete_Pages/Obsolete_Pages/Obsolete_Pages/預先定義的核心物件/Date_物件	/zh-TW/docs/Web/JavaScript/Obsolete_Pages/Obsolete_Pages/Obsolete_Pages/預先定義的核心物件/Date_物件
/zh-TW/docs/JavaScript/Obsolete_Pages/Obsolete_Pages/Obsolete_Pages/預先定義的核心物件/Function_物件	/zh-TW/docs/Web/JavaScript/Obsolete_Pages/Obsolete_Pages/Obsolete_Pages/預先定義的核心物件/Function_物件
/zh-TW/docs/JavaScript/Obsolete_Pages/Obsolete_Pages/Obsolete_Pages/預先定義的核心物件/Math_物件	/zh-TW/docs/Web/JavaScript/Obsolete_Pages/Obsolete_Pages/Obsolete_Pages/預先定義的核心物件/Math_物件
/zh-TW/docs/JavaScript/Obsolete_Pages/Obsolete_Pages/Obsolete_Pages/預先定義的核心物件/Number_物件	/zh-TW/docs/Web/JavaScript/Obsolete_Pages/Obsolete_Pages/Obsolete_Pages/預先定義的核心物件/Number_物件
/zh-TW/docs/JavaScript/Obsolete_Pages/Obsolete_Pages/Obsolete_Pages/預先定義的核心物件/RegExp_物件	/zh-TW/docs/Web/JavaScript/Obsolete_Pages/Obsolete_Pages/Obsolete_Pages/預先定義的核心物件/RegExp_物件
/zh-TW/docs/JavaScript/Obsolete_Pages/Obsolete_Pages/Obsolete_Pages/預先定義的核心物件/String_物件	/zh-TW/docs/Web/JavaScript/Obsolete_Pages/Obsolete_Pages/Obsolete_Pages/預先定義的核心物件/String_物件
/zh-TW/docs/JavaScript/Reference	/zh-TW/docs/Web/JavaScript/Reference
/zh-TW/docs/JavaScript/Reference/Global_Objects	/zh-TW/docs/Web/JavaScript/Reference/Global_Objects
/zh-TW/docs/JavaScript/Reference/Global_Objects/Function	/zh-TW/docs/Web/JavaScript/Reference/Global_Objects/Function
/zh-TW/docs/JavaScript/Reference/Global_Objects/Function/call	/zh-TW/docs/Web/JavaScript/Reference/Global_Objects/Function/call
/zh-TW/docs/JavaScript/Reference/Global_Objects/String	/zh-TW/docs/Web/JavaScript/Reference/Global_Objects/String
/zh-TW/docs/JavaScript/Reference/Global_Objects/String/replace	/zh-TW/docs/Web/JavaScript/Reference/Global_Objects/String/replace
/zh-TW/docs/JavaScript/Reference/Operators	/zh-TW/docs/Web/JavaScript/Reference/Operators
/zh-TW/docs/JavaScript/Reference/Operators/typeof	/zh-TW/docs/Web/JavaScript/Reference/Operators/typeof
/zh-TW/docs/JavaScript/Reference/Statements	/zh-TW/docs/Web/JavaScript/Reference/Statements
/zh-TW/docs/JavaScript/Reference/Statements/block	/zh-TW/docs/Web/JavaScript/Reference/Statements/block
/zh-TW/docs/JavaScript/Reference/Statements/break	/zh-TW/docs/Web/JavaScript/Reference/Statements/break
/zh-TW/docs/JavaScript/Reference/Statements/for...in	/zh-TW/docs/Web/JavaScript/Reference/Statements/for...in
/zh-TW/docs/JavaScript/Reference/Statements/var	/zh-TW/docs/Web/JavaScript/Reference/Statements/var
/zh-TW/docs/JavaScript/Same_origin_policy_for_JavaScript	/zh-TW/docs/Web/Security/Same-origin_policy
/zh-TW/docs/JavaScript_1.6_新鮮事	/zh-TW/docs/Web/JavaScript/New_in_JavaScript/1.6
/zh-TW/docs/JavaScript_1.7_新鮮事	/zh-TW/docs/Web/JavaScript/New_in_JavaScript/1.7
/zh-TW/docs/JavaScript_1.8.1_新鮮事	/zh-TW/docs/Web/JavaScript/New_in_JavaScript/1.8.1
/zh-TW/docs/JavaScript_1.8_新鮮事	/zh-TW/docs/Web/JavaScript/New_in_JavaScript/1.8
/zh-TW/docs/JavaScript_technologies_overview	/zh-TW/docs/Web/JavaScript/JavaScript_technologies_overview
/zh-TW/docs/JavaScript_technologies_overview-redirect-1	/zh-TW/docs/Web/JavaScript/JavaScript_technologies_overview
/zh-TW/docs/JavaScript_typed_arrays	/zh-TW/docs/Web/JavaScript/Typed_arrays
/zh-TW/docs/JavaScript_typed_arrays/ArrayBuffer	/zh-TW/docs/Web/JavaScript/Reference/Global_Objects/ArrayBuffer
/zh-TW/docs/JavaScript_技術簡介	/zh-TW/docs/Web/JavaScript/JavaScript_technologies_overview
/zh-TW/docs/JavaScript_正規表達式	/zh-TW/docs/Web/JavaScript/Guide/Regular_Expressions
/zh-TW/docs/JavaScript_物件導向介紹	/zh-TW/docs/Web/JavaScript/Introduction_to_Object-Oriented_JavaScript
/zh-TW/docs/JavaScript_語言的資源	/zh-TW/docs/Web/JavaScript/Language_Resources
/zh-TW/docs/Learn/CSS/CSS_轉場	/zh-TW/docs/Web/CSS/CSS_Transitions/Using_CSS_transitions
/zh-TW/docs/Learn/CSS/Consistent_List_Indentation	/zh-TW/docs/Web/CSS/CSS_Lists_and_Counters/Consistent_list_indentation
/zh-TW/docs/Learn/CSS/Getting_started	/en-US/docs/Learn/CSS/First_steps
/zh-TW/docs/Learn/CSS/Getting_started/Layout	/zh-TW/docs/Learn/CSS/CSS_layout
/zh-TW/docs/Learn/CSS/Getting_started/What_is_CSS	/en-US/docs/Learn/CSS/First_steps/How_CSS_works
/zh-TW/docs/Learn/CSS/Getting_started/Why_use_CSS	/en-US/docs/Learn/CSS/First_steps/How_CSS_works
/zh-TW/docs/Learn/CSS/Introduction_to_CSS	/en-US/docs/Learn/CSS/First_steps
/zh-TW/docs/Learn/CSS/Introduction_to_CSS/How_CSS_works	/en-US/docs/Learn/CSS/First_steps/How_CSS_works
/zh-TW/docs/Learn/CSS/Introduction_to_CSS/Layout	/zh-TW/docs/Learn/CSS/CSS_layout
/zh-TW/docs/Learn/CSS/Introduction_to_CSS/Selectors	/en-US/docs/Learn/CSS/Building_blocks/Selectors
/zh-TW/docs/Learn/CSS/Introduction_to_CSS/Syntax	/en-US/docs/Learn/CSS/First_steps/How_CSS_is_structured
/zh-TW/docs/Learn/CSS/Introduction_to_CSS/What_is_CSS	/en-US/docs/Learn/CSS/First_steps/How_CSS_works
/zh-TW/docs/Learn/CSS/Introduction_to_CSS/Why_use_CSS	/en-US/docs/Learn/CSS/First_steps/How_CSS_works
/zh-TW/docs/Learn/CSS/Styling_boxes	/en-US/docs/Learn/CSS/Building_blocks
/zh-TW/docs/Learn/CSS/Testing_media_queries	/zh-TW/docs/Web/CSS/Media_Queries/Testing_media_queries
/zh-TW/docs/Learn/CSS/Understanding_z_index	/zh-TW/docs/Web/CSS/CSS_Positioning/Understanding_z_index
/zh-TW/docs/Learn/CSS/Understanding_z_index/Stacking_context_example_1	/zh-TW/docs/Web/CSS/CSS_Positioning/Understanding_z_index/Stacking_context_example_1
/zh-TW/docs/Learn/CSS/Using_the_:target_selector	/zh-TW/docs/Web/CSS/CSS_Selectors/Using_the_:target_pseudo-class_in_selectors
/zh-TW/docs/Learn/CSS/文字樣式	/zh-TW/docs/Learn/CSS/Styling_text
/zh-TW/docs/Learn/CSS/樣式化容器	/en-US/docs/Learn/CSS/Building_blocks
/zh-TW/docs/Learn/HTML/HTML介紹	/zh-TW/docs/Learn/HTML/Introduction_to_HTML
/zh-TW/docs/Learn/JavaScript/Building_blocks/函數	/zh-TW/docs/Learn/JavaScript/Building_blocks/Functions
/zh-TW/docs/Learn/JavaScript/Building_blocks/回傳值	/zh-TW/docs/Learn/JavaScript/Building_blocks/Return_values
/zh-TW/docs/Learn/JavaScript/Building_blocks/建立自己的功能函數	/zh-TW/docs/Learn/JavaScript/Building_blocks/Build_your_own_function
/zh-TW/docs/Learn/JavaScript/Building_blocks/循環代碼	/zh-TW/docs/Learn/JavaScript/Building_blocks/Looping_code
/zh-TW/docs/Learn/JavaScript/Building_blocks/條件	/zh-TW/docs/Learn/JavaScript/Building_blocks/conditionals
/zh-TW/docs/Learn/JavaScript/First_steps/傻故事產生器	/zh-TW/docs/Learn/JavaScript/First_steps/Silly_story_generator
/zh-TW/docs/Learn/JavaScript/First_steps/初次接觸	/zh-TW/docs/Learn/JavaScript/First_steps/A_first_splash
/zh-TW/docs/Learn/JavaScript/First_steps/字符串	/zh-TW/docs/Learn/JavaScript/First_steps/Strings
/zh-TW/docs/Learn/JavaScript/First_steps/數學	/zh-TW/docs/Learn/JavaScript/First_steps/Math
/zh-TW/docs/Learn/JavaScript/First_steps/有用的字符串方法	/zh-TW/docs/Learn/JavaScript/First_steps/Useful_string_methods
/zh-TW/docs/Learn/JavaScript/First_steps/變數	/zh-TW/docs/Learn/JavaScript/First_steps/Variables
/zh-TW/docs/Learn/JavaScript/First_steps/陣列	/zh-TW/docs/Learn/JavaScript/First_steps/Arrays
/zh-TW/docs/Learn/JavaScript/如何運用	/zh-TW/docs/Learn/JavaScript/Howto
/zh-TW/docs/Learn/JavaScript/第一步	/zh-TW/docs/Learn/JavaScript/First_steps
/zh-TW/docs/MDN/Contribute/Content	/zh-TW/docs/MDN/Guidelines
/zh-TW/docs/MDN/Contribute/Content/Style_guide	/zh-TW/docs/MDN/Guidelines/Writing_style_guide
/zh-TW/docs/MDN/Contribute/Creating_and_editing_pages	/zh-TW/docs/MDN/Contribute/Howto/Create_and_edit_pages
/zh-TW/docs/MDN/Contribute/Editor	/zh-TW/docs/MDN/Editor
/zh-TW/docs/MDN/Contribute/Editor/Basics	/zh-TW/docs/MDN/Editor/Basics
/zh-TW/docs/MDN/Contribute/Editor/Edit_box	/zh-TW/docs/MDN/Editor/Edit_box
/zh-TW/docs/MDN/Contribute/Guidelines	/zh-TW/docs/MDN/Guidelines
/zh-TW/docs/MDN/Contribute/Guidelines/Style_guide	/zh-TW/docs/MDN/Guidelines/Writing_style_guide
/zh-TW/docs/MDN/Contribute/Guidelines/Writing_style_guide	/zh-TW/docs/MDN/Guidelines/Writing_style_guide
/zh-TW/docs/MDN/Contribute/Howto/編輯審查	/zh-TW/docs/MDN/Contribute/Howto/Do_an_editorial_review
/zh-TW/docs/MDN/Contribute/Tools	/zh-TW/docs/MDN/Tools
/zh-TW/docs/MDN/Contribute/Tools/KumaScript	/zh-TW/docs/MDN/Tools/KumaScript
/zh-TW/docs/MDN/Contribute/Tools/KumaScript/Troubleshooting	/zh-TW/docs/MDN/Tools/KumaScript/Troubleshooting
/zh-TW/docs/MDN/Getting_started	/zh-TW/docs/MDN/Contribute/Getting_started
/zh-TW/docs/MDN/Kuma/Troubleshooting_KumaScript_errors	/zh-TW/docs/MDN/Tools/KumaScript/Troubleshooting
/zh-TW/docs/Mozilla/Add-ons/WebExtensions/Porting_from_Google_Chrome	https://extensionworkshop.com/documentation/develop/porting-a-google-chrome-extension/
/zh-TW/docs/Mozilla/Add-ons/WebExtensions/manifest.json/applications	/zh-TW/docs/Mozilla/Add-ons/WebExtensions/manifest.json/browser_specific_settings
/zh-TW/docs/Mozilla/Add-ons/WebExtensions/manifest.json/作者	/zh-TW/docs/Mozilla/Add-ons/WebExtensions/manifest.json/author
/zh-TW/docs/Mozilla/Add-ons/WebExtensions/user_interface/側邊欄	/zh-TW/docs/Mozilla/Add-ons/WebExtensions/user_interface/Sidebars
/zh-TW/docs/Mozilla/Add-ons/WebExtensions/user_interface/工具列按鈕	/zh-TW/docs/Mozilla/Add-ons/WebExtensions/user_interface/Browser_action
/zh-TW/docs/Mozilla/Add-ons/WebExtensions/user_interface/快捷選單項	/zh-TW/docs/Mozilla/Add-ons/WebExtensions/user_interface/Context_menu_items
/zh-TW/docs/Mozilla/Add-ons/WebExtensions/user_interface/開發工具面板	/zh-TW/docs/Mozilla/Add-ons/WebExtensions/user_interface/devtools_panels
/zh-TW/docs/Mozilla/Add-ons/WebExtensions/用戶介面	/zh-TW/docs/Mozilla/Add-ons/WebExtensions/user_interface
/zh-TW/docs/Mozilla/Add-ons/WebExtensions/用戶介面/側邊欄	/zh-TW/docs/Mozilla/Add-ons/WebExtensions/user_interface/Sidebars
/zh-TW/docs/Mozilla/Add-ons/WebExtensions/用戶介面/工具列按鈕	/zh-TW/docs/Mozilla/Add-ons/WebExtensions/user_interface/Browser_action
/zh-TW/docs/Mozilla/Add-ons/WebExtensions/用戶介面/快捷選單項	/zh-TW/docs/Mozilla/Add-ons/WebExtensions/user_interface/Context_menu_items
/zh-TW/docs/Mozilla/Add-ons/WebExtensions/用戶介面/開發工具面板	/zh-TW/docs/Mozilla/Add-ons/WebExtensions/user_interface/devtools_panels
/zh-TW/docs/Mozilla/Add-ons/WebExtensions/用戶體驗最佳實踐	https://extensionworkshop.com/documentation/develop/user-experience-best-practices/
/zh-TW/docs/Mozilla/Developer_guide/介紹	/zh-TW/docs/Mozilla/Developer_guide/Introduction
/zh-TW/docs/Mozilla/Developer_guide/原始碼	/zh-TW/docs/Mozilla/Developer_guide/Source_Code
/zh-TW/docs/Mozilla/Firefox/Releases/2/Firefox_2_的安全功能	/zh-TW/docs/Mozilla/Firefox/Releases/2/Security_changes
/zh-TW/docs/Mozilla/Firefox/Releases/2/新增消息來源閱讀工具	/zh-TW/docs/Mozilla/Firefox/Releases/2/Adding_feed_readers_to_Firefox
/zh-TW/docs/Mozilla/Firefox/Releases/3/Firefox_3_Dom_Improvements	/zh-TW/docs/Mozilla/Firefox/Releases/3/DOM_improvements
/zh-TW/docs/Mozilla_event_reference	/zh-TW/docs/Web/Events
/zh-TW/docs/Mozilla_event_reference/DOMContentLoaded_(event)	/zh-TW/docs/Web/Events/DOMContentLoaded
/zh-TW/docs/Offline_resources_on_Firefox	/zh-TW/docs/Web/HTML/Using_the_application_cache
/zh-TW/docs/Prism:主視窗	/zh-TW/docs/Prism/主視窗
/zh-TW/docs/Prism:安裝程式	/zh-TW/docs/Prism/安裝程式
/zh-TW/docs/Quirks_Mode_and_Standards_Mode	/zh-TW/docs/Web/HTML/Quirks_Mode_and_Standards_Mode
/zh-TW/docs/SVG	/zh-TW/docs/Web/SVG
/zh-TW/docs/SVG/Tutorial	/zh-TW/docs/Web/SVG/Tutorial
/zh-TW/docs/SVG/Tutorial/Introduction	/zh-TW/docs/Web/SVG/Tutorial/Introduction
/zh-TW/docs/SVG/Tutorial/Positions	/zh-TW/docs/Web/SVG/Tutorial/Positions
/zh-TW/docs/SVG/Tutorial/入门	/zh-TW/docs/Web/SVG/Tutorial/Getting_Started
/zh-TW/docs/SVG/Tutorial/图案	/zh-TW/docs/Web/SVG/Tutorial/Patterns
/zh-TW/docs/SVG/Tutorial/基本形状	/zh-TW/docs/SVG/Tutorial/Basic_Shapes
/zh-TW/docs/SVG/Tutorial/填充与边框	/zh-TW/docs/Web/SVG/Tutorial/Fills_and_Strokes
/zh-TW/docs/SVG/Tutorial/渐变	/zh-TW/docs/Web/SVG/Tutorial/Gradients
/zh-TW/docs/SVG/Tutorial/路径	/zh-TW/docs/Web/SVG/Tutorial/路径
/zh-TW/docs/SVG/教學	/zh-TW/docs/Web/SVG/教學
/zh-TW/docs/Security/MixedContent	/zh-TW/docs/Web/Security/Mixed_content
/zh-TW/docs/Security/MixedContent/How_to_fix_website_with_mixed_content	/zh-TW/docs/Web/Security/Mixed_content/How_to_fix_website_with_mixed_content
/zh-TW/docs/Security/弱簽章演算法	/zh-TW/docs/Web/Security/Weak_Signature_Algorithm
/zh-TW/docs/Security/缺少安全性的密碼	/zh-TW/docs/Web/Security/Insecure_passwords
/zh-TW/docs/Using_files_from_web_applications	/zh-TW/docs/Web/API/File/Using_files_from_web_applications
/zh-TW/docs/Using_geolocation	/zh-TW/docs/Web/API/Geolocation/Using_geolocation
/zh-TW/docs/Web/API/Canvas_API/Tutorial/基礎動畫	/zh-TW/docs/Web/API/Canvas_API/Tutorial/Basic_animations
/zh-TW/docs/Web/API/Canvas_API/Tutorial/最佳化_canvas	/zh-TW/docs/Web/API/Canvas_API/Tutorial/Optimizing_canvas
/zh-TW/docs/Web/API/Coordinates	/zh-TW/docs/Web/API/GeolocationCoordinates
/zh-TW/docs/Web/API/Coordinates/accuracy	/zh-TW/docs/Web/API/GeolocationCoordinates/accuracy
/zh-TW/docs/Web/API/Coordinates/altitude	/zh-TW/docs/Web/API/GeolocationCoordinates/altitude
/zh-TW/docs/Web/API/Coordinates/altitudeAccuracy	/zh-TW/docs/Web/API/GeolocationCoordinates/altitudeAccuracy
/zh-TW/docs/Web/API/Coordinates/heading	/zh-TW/docs/Web/API/GeolocationCoordinates/heading
/zh-TW/docs/Web/API/Coordinates/latitude	/zh-TW/docs/Web/API/GeolocationCoordinates/latitude
/zh-TW/docs/Web/API/Coordinates/longitude	/zh-TW/docs/Web/API/GeolocationCoordinates/longitude
/zh-TW/docs/Web/API/Coordinates/speed	/zh-TW/docs/Web/API/GeolocationCoordinates/speed
/zh-TW/docs/Web/API/DocumentTemp	/zh-TW/docs/Web/API/Document
/zh-TW/docs/Web/API/DocumentTemp/createElement	/zh-TW/docs/Web/API/Document/createElement
/zh-TW/docs/Web/API/DocumentTemp/createRange	/zh-TW/docs/Web/API/Document/createRange
/zh-TW/docs/Web/API/DocumentTemp/createTextNode	/zh-TW/docs/Web/API/Document/createTextNode
/zh-TW/docs/Web/API/DocumentTemp/defaultView	/zh-TW/docs/Web/API/Document/defaultView
/zh-TW/docs/Web/API/DocumentTemp/forms	/zh-TW/docs/Web/API/Document/forms
/zh-TW/docs/Web/API/DocumentTemp/getElementsByClassName	/zh-TW/docs/Web/API/Document/getElementsByClassName
/zh-TW/docs/Web/API/DocumentTemp/head	/zh-TW/docs/Web/API/Document/head
/zh-TW/docs/Web/API/DocumentTemp/querySelector	/zh-TW/docs/Web/API/Document/querySelector
/zh-TW/docs/Web/API/DocumentTemp/readyState	/zh-TW/docs/Web/API/Document/readyState
/zh-TW/docs/Web/API/DocumentTemp/width	/zh-TW/docs/Web/API/Document/width
/zh-TW/docs/Web/API/Document_Object_Model/Whitespace_in_the_DOM	/zh-TW/docs/Web/API/Document_Object_Model/Whitespace
/zh-TW/docs/Web/API/Position	/zh-TW/docs/Web/API/GeolocationPosition
/zh-TW/docs/Web/API/Position/coords	/zh-TW/docs/Web/API/GeolocationPosition/coords
/zh-TW/docs/Web/API/Position/timestamp	/zh-TW/docs/Web/API/GeolocationPosition/timestamp
/zh-TW/docs/Web/API/PositionError	/zh-TW/docs/Web/API/GeolocationPositionError
/zh-TW/docs/Web/API/PositionError/code	/zh-TW/docs/Web/API/GeolocationPositionError/code
/zh-TW/docs/Web/API/PositionError/message	/zh-TW/docs/Web/API/GeolocationPositionError/message
/zh-TW/docs/Web/API/WebGL_API/Tutorial/WebGL入門	/zh-TW/docs/Web/API/WebGL_API/Tutorial/Getting_started_with_WebGL
/zh-TW/docs/Web/API/XMLHttpRequest/FormData	/zh-TW/docs/Web/API/FormData
/zh-TW/docs/Web/API/document.querySelector	/zh-TW/docs/Web/API/Document/querySelector
/zh-TW/docs/Web/Apps/Progressive	/zh-TW/docs/Web/Progressive_web_apps
/zh-TW/docs/Web/Apps/Progressive/Responsive	/zh-TW/docs/Web/Progressive_web_apps/Responsive
/zh-TW/docs/Web/CSS/-moz-border-image	/zh-TW/docs/Web/CSS/border-image/border-image
/zh-TW/docs/Web/CSS/CSS_Box_Model/理解邊界重疊的原因	/zh-TW/docs/Web/CSS/CSS_Box_Model/Mastering_margin_collapsing
/zh-TW/docs/Web/CSS/CSS_一般問題	/zh-TW/docs/Web/CSS/Common_CSS_Questions
/zh-TW/docs/Web/CSS/CSS_網格_布局	/zh-TW/docs/Web/CSS/CSS_Grid_Layout
/zh-TW/docs/Web/CSS/Descendant_selectors	/zh-TW/docs/Web/CSS/Descendant_combinator
/zh-TW/docs/Web/CSS/attr	/zh-TW/docs/Web/CSS/attr()
/zh-TW/docs/Web/CSS/radial-gradient	/zh-TW/docs/Web/CSS/radial-gradient()
/zh-TW/docs/Web/CSS/transform-function/translate3d	/zh-TW/docs/Web/CSS/transform-function/translate3d()
/zh-TW/docs/Web/CSS/參考	/zh-TW/docs/Web/CSS/Reference
/zh-TW/docs/Web/CSS/彈頭	/zh-TW/docs/Web/CSS/box-sizing
/zh-TW/docs/Web/CSS/繼承	/zh-TW/docs/Web/CSS/inheritance
/zh-TW/docs/Web/CSS/語法	/zh-TW/docs/Web/CSS/Syntax
/zh-TW/docs/Web/Events/click	/zh-TW/docs/Web/API/Element/click_event
/zh-TW/docs/Web/Events/keyup	/zh-TW/docs/Web/API/Document/keyup_event
/zh-TW/docs/Web/Events/orientationchange	/zh-TW/docs/Web/API/Window/orientationchange_event
/zh-TW/docs/Web/Events/ratechange	/zh-TW/docs/Web/API/HTMLMediaElement/ratechange_event
/zh-TW/docs/Web/Events/scroll	/zh-TW/docs/Web/API/Document/scroll_event
/zh-TW/docs/Web/Events/submit	/zh-TW/docs/Web/API/HTMLFormElement/submit_event
/zh-TW/docs/Web/Events/touchcancel	/zh-TW/docs/Web/API/Element/touchcancel_event
/zh-TW/docs/Web/Guide/API/DOM/Manipulating_the_browser_history/Manipulating_the_browser_history	/zh-TW/docs/Web/API/History_API
/zh-TW/docs/Web/Guide/API/WebRTC	/zh-TW/docs/Web/API/WebRTC_API
/zh-TW/docs/Web/Guide/CSS	/zh-TW/docs/Learn/CSS
/zh-TW/docs/Web/Guide/CSS/CSS_轉場	/zh-TW/docs/Web/CSS/CSS_Transitions/Using_CSS_transitions
/zh-TW/docs/Web/Guide/CSS/Consistent_List_Indentation	/zh-TW/docs/Web/CSS/CSS_Lists_and_Counters/Consistent_list_indentation
/zh-TW/docs/Web/Guide/CSS/Getting_started	/en-US/docs/Learn/CSS/First_steps
/zh-TW/docs/Web/Guide/CSS/Getting_started/Layout	/zh-TW/docs/Learn/CSS/CSS_layout
/zh-TW/docs/Web/Guide/CSS/Getting_started/What_is_CSS	/en-US/docs/Learn/CSS/First_steps/How_CSS_works
/zh-TW/docs/Web/Guide/CSS/Getting_started/Why_use_CSS	/en-US/docs/Learn/CSS/First_steps/How_CSS_works
/zh-TW/docs/Web/Guide/CSS/Getting_started/為什麼要用CSS	/en-US/docs/Learn/CSS/First_steps/How_CSS_works
/zh-TW/docs/Web/Guide/CSS/Testing_media_queries	/zh-TW/docs/Web/CSS/Media_Queries/Testing_media_queries
/zh-TW/docs/Web/Guide/CSS/Understanding_z_index	/zh-TW/docs/Web/CSS/CSS_Positioning/Understanding_z_index
/zh-TW/docs/Web/Guide/CSS/Understanding_z_index/Stacking_context_example_1	/zh-TW/docs/Web/CSS/CSS_Positioning/Understanding_z_index/Stacking_context_example_1
/zh-TW/docs/Web/Guide/CSS/Using_the_:target_selector	/zh-TW/docs/Web/CSS/CSS_Selectors/Using_the_:target_pseudo-class_in_selectors
/zh-TW/docs/Web/Guide/CSS/使用_多重_背景	/zh-TW/docs/Web/CSS/CSS_Background_and_Borders/Using_CSS_multiple_backgrounds
/zh-TW/docs/Web/Guide/DOM/Manipulating_the_browser_history	/zh-TW/docs/Web/API/History_API
/zh-TW/docs/Web/Guide/DOM/Using_full_screen_mode	/zh-TW/docs/Web/API/Fullscreen_API
/zh-TW/docs/Web/Guide/HTML	/zh-TW/docs/Learn/HTML
/zh-TW/docs/Web/Guide/HTML/Canvas_tutorial	/zh-TW/docs/Web/API/Canvas_API/Tutorial
/zh-TW/docs/Web/Guide/HTML/Canvas_tutorial/Applying_styles_and_colors	/zh-TW/docs/Web/API/Canvas_API/Tutorial/Applying_styles_and_colors
/zh-TW/docs/Web/Guide/HTML/Canvas_tutorial/Basic_usage	/zh-TW/docs/Web/API/Canvas_API/Tutorial/Basic_usage
/zh-TW/docs/Web/Guide/HTML/Canvas_tutorial/Compositing	/zh-TW/docs/Web/API/Canvas_API/Tutorial/Compositing
/zh-TW/docs/Web/Guide/HTML/Canvas_tutorial/Drawing_shapes	/zh-TW/docs/Web/API/Canvas_API/Tutorial/Drawing_shapes
/zh-TW/docs/Web/Guide/HTML/Canvas_tutorial/Transformations	/zh-TW/docs/Web/API/Canvas_API/Tutorial/Transformations
/zh-TW/docs/Web/Guide/HTML/Canvas_tutorial/Using_images	/zh-TW/docs/Web/API/Canvas_API/Tutorial/Using_images
/zh-TW/docs/Web/Guide/HTML/Canvas_tutorial/基礎動畫	/zh-TW/docs/Web/API/Canvas_API/Tutorial/Basic_animations
/zh-TW/docs/Web/Guide/HTML/Canvas_tutorial/最佳化_canvas	/zh-TW/docs/Web/API/Canvas_API/Tutorial/Optimizing_canvas
/zh-TW/docs/Web/Guide/HTML/Drag_and_drop	/zh-TW/docs/Web/API/HTML_Drag_and_Drop_API
/zh-TW/docs/Web/Guide/HTML/Drag_operations	/zh-TW/docs/Web/API/HTML_Drag_and_Drop_API/Drag_operations
/zh-TW/docs/Web/Guide/HTML/Forms	/zh-TW/docs/Learn/HTML/Forms
/zh-TW/docs/Web/Guide/HTML/Forms/How_to_structure_an_HTML_form	/zh-TW/docs/Learn/HTML/Forms/How_to_structure_an_HTML_form
/zh-TW/docs/Web/Guide/Performance/Using_web_workers	/zh-TW/docs/Web/API/Web_Workers_API/Using_web_workers
/zh-TW/docs/Web/Guide/圖像	/zh-TW/docs/Web/Guide/Graphics
/zh-TW/docs/Web/HTML/Canvas	/zh-TW/docs/Web/API/Canvas_API
/zh-TW/docs/Web/HTML/Canvas/Drawing_graphics_with_canvas	/zh-TW/docs/Web/API/Canvas_API/Drawing_graphics_with_canvas
/zh-TW/docs/Web/HTML/Element/HTML_元素	/zh-TW/docs/Web/HTML/Element
/zh-TW/docs/Web/HTML/Element/導航欄	/zh-TW/docs/Web/HTML/Element/nav
/zh-TW/docs/Web/HTML/Element_old	/zh-TW/docs/Web/HTML/HTML_元素
/zh-TW/docs/Web/HTML/HTML5	/zh-TW/docs/Web/Guide/HTML/HTML5
/zh-TW/docs/Web/HTML/HTML5/Introduction_to_HTML5	/zh-TW/docs/Web/Guide/HTML/HTML5/Introduction_to_HTML5
/zh-TW/docs/Web/HTML/HTML5_表單	/zh-TW/docs/Learn/HTML/Forms
/zh-TW/docs/Web/HTML/Introduction	/zh-CN/docs/learn/HTML/Introduction_to_HTML
/zh-TW/docs/Web/HTML/Offline_resources_on_Firefox	/zh-TW/docs/Web/HTML/Using_the_application_cache
/zh-TW/docs/Web/HTML/區塊級元素	/zh-TW/docs/Web/HTML/Block-level_elements
/zh-TW/docs/Web/HTTP/Access_control_CORS	/zh-TW/docs/Web/HTTP/CORS
/zh-TW/docs/Web/HTTP/Response_codes	/zh-TW/docs/Web/HTTP/Status
/zh-TW/docs/Web/HTTP/X-Frame-Options	/zh-TW/docs/Web/HTTP/Headers/X-Frame-Options
/zh-TW/docs/Web/JavaScript/Guide/JavaScript_Overview	/zh-TW/docs/Web/JavaScript/Guide/Introduction
/zh-TW/docs/Web/JavaScript/Guide/JavaScript_概觀	/zh-TW/docs/Web/JavaScript/Guide/Introduction
/zh-TW/docs/Web/JavaScript/Guide/JavaScript_概觀（JavaScript_Overview）	/zh-TW/docs/Web/JavaScript/Guide/Introduction
/zh-TW/docs/Web/JavaScript/Guide/Obsolete_Pages	/zh-TW/docs/Web/JavaScript/Guide
/zh-TW/docs/Web/JavaScript/Guide/Values,_variables,_and_literals	/zh-TW/docs/Web/JavaScript/Guide/Grammar_and_types
/zh-TW/docs/Web/JavaScript/Guide_old	/zh-TW/docs/Web/JavaScript/Guide
/zh-TW/docs/Web/JavaScript/Guide_old/Details_of_the_Object_Model	/zh-TW/docs/Web/JavaScript/Guide/Details_of_the_Object_Model
/zh-TW/docs/Web/JavaScript/Guide_old/Functions	/zh-TW/docs/Web/JavaScript/Guide/Functions
/zh-TW/docs/Web/JavaScript/Guide_old/Grammar_and_types	/zh-TW/docs/Web/JavaScript/Guide/Grammar_and_types
/zh-TW/docs/Web/JavaScript/Guide_old/Introduction	/zh-TW/docs/Web/JavaScript/Guide/Introduction
/zh-TW/docs/Web/JavaScript/Guide_old/JavaScript_概觀	/zh-TW/docs/Web/JavaScript/Guide/Introduction
/zh-TW/docs/Web/JavaScript/Guide_old/JavaScript_概觀（JavaScript_Overview）	/zh-TW/docs/Web/JavaScript/Guide/Introduction
/zh-TW/docs/Web/JavaScript/Guide_old/Keyed_collections	/zh-TW/docs/Web/JavaScript/Guide/Keyed_collections
/zh-TW/docs/Web/JavaScript/Guide_old/Regular_Expressions	/zh-TW/docs/Web/JavaScript/Guide/Regular_Expressions
/zh-TW/docs/Web/JavaScript/Guide_old/Working_with_Objects	/zh-TW/docs/Web/JavaScript/Guide/Working_with_Objects
/zh-TW/docs/Web/JavaScript/JavaScript_typed_arrays	/zh-TW/docs/Web/JavaScript/Typed_arrays
/zh-TW/docs/Web/JavaScript/JavaScript_typed_arrays/ArrayBuffer	/zh-TW/docs/Web/JavaScript/Reference/Global_Objects/ArrayBuffer
/zh-TW/docs/Web/JavaScript/JavaScript_typed_arrays/ArrayBuffer/prototype	/zh-TW/docs/Web/JavaScript/Reference/Global_Objects/ArrayBuffer/prototype
/zh-TW/docs/Web/JavaScript/New_in_JavaScript/JavaScript_1.6_新鮮事	/zh-TW/docs/Web/JavaScript/New_in_JavaScript/1.6
/zh-TW/docs/Web/JavaScript/New_in_JavaScript/JavaScript_1.7_新鮮事	/zh-TW/docs/Web/JavaScript/New_in_JavaScript/1.7
/zh-TW/docs/Web/JavaScript/Obsolete_Pages/Control_flow_and_error_handling	/zh-TW/docs/Web/JavaScript/Guide/Control_flow_and_error_handling
/zh-TW/docs/Web/JavaScript/Obsolete_Pages/Expressions_and_Operators	/zh-TW/docs/Web/JavaScript/Guide/Expressions_and_Operators
/zh-TW/docs/Web/JavaScript/Obsolete_Pages/Keyed_collections	/zh-TW/docs/Web/JavaScript/Guide/Keyed_collections
/zh-TW/docs/Web/JavaScript/Obsolete_Pages/Loops_and_iteration	/zh-TW/docs/Web/JavaScript/Guide/Loops_and_iteration
/zh-TW/docs/Web/JavaScript/Obsolete_Pages/Obsolete_Pages	/zh-TW/docs/Web/JavaScript/Guide
/zh-TW/docs/Web/JavaScript/Obsolete_Pages/Obsolete_Pages/Obsolete_Pages	/zh-TW/docs/Web/JavaScript/Guide
/zh-TW/docs/Web/JavaScript/Obsolete_Pages/Obsolete_Pages/Obsolete_Pages/arguments_物件的使用	/zh-TW/docs/Web/JavaScript/Reference/Functions/arguments
/zh-TW/docs/Web/JavaScript/Obsolete_Pages/Obsolete_Pages/Obsolete_Pages/區塊文法	/zh-TW/docs/Web/JavaScript/Obsolete_Pages/Obsolete_Pages/Obsolete_Pages/區塊語法
/zh-TW/docs/Web/JavaScript/Obsolete_Pages/Obsolete_Pages/Obsolete_Pages/建立新的物件/物件初始化子的使用	/zh-TW/docs/Web/JavaScript/Obsolete_Pages/Obsolete_Pages/Obsolete_Pages/新物件的建立/物件初始化子的使用
/zh-TW/docs/Web/JavaScript/Obsolete_Pages/Obsolete_Pages/Obsolete_Pages/文法	/zh-TW/docs/Core_JavaScript_1.5_教學/語法
/zh-TW/docs/Web/JavaScript/Obsolete_Pages/Obsolete_Pages/Obsolete_Pages/條件文法	/zh-TW/docs/Web/JavaScript/Obsolete_Pages/Obsolete_Pages/Obsolete_Pages/條件語法
/zh-TW/docs/Web/JavaScript/Obsolete_Pages/Obsolete_Pages/Obsolete_Pages/正則表達式	/zh-TW/docs/Core_JavaScript_1.5_教學/正規表達式
/zh-TW/docs/Web/JavaScript/Obsolete_Pages/Obsolete_Pages/Obsolete_Pages/正則表達式模式的編寫	/zh-TW/docs/Web/JavaScript/Obsolete_Pages/Obsolete_Pages/Obsolete_Pages/正規表達式模式的編寫
/zh-TW/docs/Web/JavaScript/Obsolete_Pages/Obsolete_Pages/Obsolete_Pages/正則表達式的建立	/zh-TW/docs/Web/JavaScript/Obsolete_Pages/Obsolete_Pages/Obsolete_Pages/正規表達式的建立
/zh-TW/docs/Web/JavaScript/Obsolete_Pages/Obsolete_Pages/Obsolete_Pages/正則表達式的運用	/zh-TW/docs/Web/JavaScript/Obsolete_Pages/Obsolete_Pages/Obsolete_Pages/正規表達式的運用
/zh-TW/docs/Web/JavaScript/Obsolete_Pages/Obsolete_Pages/Obsolete_Pages/正則表達式的運用/使用標誌的進階搜尋	/zh-TW/docs/Web/JavaScript/Obsolete_Pages/Obsolete_Pages/Obsolete_Pages/正規表達式的運用/使用標誌的進階搜尋
/zh-TW/docs/Web/JavaScript/Obsolete_Pages/Obsolete_Pages/Obsolete_Pages/正則表達式的運用/括弧子字串的比對結果的運用	/zh-TW/docs/Web/JavaScript/Obsolete_Pages/Obsolete_Pages/Obsolete_Pages/正規表達式的運用/括弧子字串的比對結果的運用
/zh-TW/docs/Web/JavaScript/Obsolete_Pages/Obsolete_Pages/Obsolete_Pages/正則表達式的運用/正則表達式的範例	/zh-TW/docs/Web/JavaScript/Obsolete_Pages/Obsolete_Pages/Obsolete_Pages/正規表達式的運用/正規表達式的範例
/zh-TW/docs/Web/JavaScript/Obsolete_Pages/Obsolete_Pages/Obsolete_Pages/正規表達式的運用/正則表達式的範例	/zh-TW/docs/Web/JavaScript/Obsolete_Pages/Obsolete_Pages/Obsolete_Pages/正規表達式的運用/正規表達式的範例
/zh-TW/docs/Web/JavaScript/Same_origin_policy_for_JavaScript	/zh-TW/docs/Web/Security/Same-origin_policy
/zh-TW/docs/Web/JavaScript/Typed_arrays/ArrayBuffer	/zh-TW/docs/Web/JavaScript/Reference/Global_Objects/ArrayBuffer
/zh-TW/docs/Web/JavaScript/Typed_arrays/ArrayBuffer/prototype	/zh-TW/docs/Web/JavaScript/Reference/Global_Objects/ArrayBuffer/prototype
/zh-TW/docs/Web/JavaScript/資料結構	/zh-TW/docs/Web/JavaScript/Data_structures
/zh-TW/docs/Web/JavaScript/重新介紹_JavaScript	/zh-TW/docs/Web/JavaScript/A_re-introduction_to_JavaScript
/zh-TW/docs/Web/Reference/Events	/zh-TW/docs/Web/Events
/zh-TW/docs/Web/Reference/Events/DOMContentLoaded	/zh-TW/docs/Web/Events/DOMContentLoaded
/zh-TW/docs/Web/Reference/Events/DOMContentLoaded_(event)	/zh-TW/docs/Web/Events/DOMContentLoaded
/zh-TW/docs/Web/Reference/Events/click	/zh-TW/docs/Web/API/Element/click_event
/zh-TW/docs/Web/Reference/Events/submit	/zh-TW/docs/Web/API/HTMLFormElement/submit_event
/zh-TW/docs/Web/Reference/Events/touchcancel	/zh-TW/docs/Web/API/Element/touchcancel_event
/zh-TW/docs/Web/SVG/Tutorial/入门	/zh-TW/docs/Web/SVG/Tutorial/Getting_Started
/zh-TW/docs/Web/SVG/Tutorial/图案	/zh-TW/docs/Web/SVG/Tutorial/Patterns
/zh-TW/docs/Web/SVG/Tutorial/基本形状	/zh-TW/docs/SVG/Tutorial/Basic_Shapes
/zh-TW/docs/Web/SVG/Tutorial/填充与边框	/zh-TW/docs/Web/SVG/Tutorial/Fills_and_Strokes
/zh-TW/docs/Web/SVG/Tutorial/渐变	/zh-TW/docs/Web/SVG/Tutorial/Gradients
/zh-TW/docs/Web/WebGL	/zh-TW/docs/Web/API/WebGL_API
/zh-TW/docs/WebAPI/Battery_Status	/zh-TW/docs/Web/API/Battery_Status_API
/zh-TW/docs/WebAPI/Detecting_device_orientation	/zh-TW/docs/Web/API/Detecting_device_orientation
/zh-TW/docs/WebAPI/FileHandle	/zh-TW/docs/Web/API/File_Handle_API
/zh-TW/docs/WebAPI/Managing_screen_orientation	/zh-TW/docs/Web/API/CSS_Object_Model/Managing_screen_orientation
/zh-TW/docs/WebAPI/Network_Information	/zh-TW/docs/Web/API/Network_Information_API
/zh-TW/docs/WebAPI/Pointer_Lock	/zh-TW/docs/Web/API/Pointer_Lock_API
/zh-TW/docs/WebAPI/Proximity	/zh-TW/docs/Web/API/Proximity_Events
/zh-TW/docs/WebAPI/Using_Light_Events	/zh-TW/docs/Web/API/Ambient_Light_Events
/zh-TW/docs/WebAPI/Using_Web_Notifications	/zh-TW/docs/Web/API/Notifications_API/Using_the_Notifications_API
/zh-TW/docs/WebAPI/Vibration	/zh-TW/docs/Web/API/Vibration_API
/zh-TW/docs/Web_Audio_API	/zh-TW/docs/Web/API/Web_Audio_API
/zh-TW/docs/Web_development/Writing_forward-compatible_websites	/zh-TW/docs/Web/Guide/Writing_forward-compatible_websites
/zh-TW/docs/Web_開發/Web開發入門	/zh-TW/docs/Web/Guide/Introduction_to_Web_development
/zh-TW/docs/en	/en-US/
/zh-TW/docs/介紹	/zh-TW/docs/Mozilla/Developer_guide/Introduction
/zh-TW/docs/應用程式-840092-dup	/zh-TW/docs/Web/Apps
/zh-TW/docs/應用程式-840092-dup/Basics	/zh-TW/docs/Web/Apps/Basics
/zh-TW/docs/應用程式-840092-dup/Design	/zh-TW/docs/Web/Apps/Design
/zh-TW/docs/應用程式-840092-dup/Developing	/zh-TW/docs/Web/Apps/Developing
/zh-TW/docs/應用程式-840092-dup/FAQs	/zh-TW/docs/Web/Apps/FAQs
/zh-TW/docs/應用程式-840092-dup/For_Web_developers	/zh-TW/docs/Web/Apps/For_Web_developers
/zh-TW/docs/應用程式-840092-dup/For_mobile_developers	/zh-TW/docs/Web/Apps/For_mobile_developers
/zh-TW/docs/應用程式-840092-dup/Getting_Started	/zh-TW/docs/Web/Apps/Getting_Started
/zh-TW/docs/應用程式-840092-dup/Publishing	/zh-TW/docs/Web/Apps/Publishing
/zh-TW/docs/應用程式-840092-dup/Quickstart	/zh-TW/docs/Web/Apps/Quickstart
/zh-TW/docs/應用程式-840092-dup/Quickstart/Design	/zh-TW/docs/Web/Apps/Quickstart/Design
/zh-TW/docs/應用程式-840092-dup/Quickstart/Design/Concept_A_great_app	/zh-TW/docs/Web/Apps/Quickstart/Design/Concept_A_great_app
/zh-TW/docs/應用程式-840092-dup/Tutorials	/zh-TW/docs/Web/Apps/Tutorials
/zh-TW/docs/應用程式-840092-dup/Tutorials/Audio_and_video	/zh-TW/docs/Web/Apps/Tutorials/Audio_and_video
/zh-TW/docs/應用程式-840092-dup/Tutorials/Debugging_the_app	/zh-TW/docs/Web/Apps/Tutorials/Debugging_the_app
/zh-TW/docs/應用程式-840092-dup/Tutorials/Games	/zh-TW/docs/Web/Apps/Tutorials/Games
/zh-TW/docs/應用程式-840092-dup/Tutorials/General	/zh-TW/docs/Web/Apps/Tutorials/General
/zh-TW/docs/應用程式-840092-dup/Tutorials/General/Maintaining_the_app	/zh-TW/docs/Web/Apps/Tutorials/General/Maintaining_the_app
/zh-TW/docs/應用程式/Manifest-840092-dup	/zh-TW/docs/Web/Apps/Developing/Manifest/Manifest-840092-dup
/zh-TW/docs/控制_HTML_表單中的拼字檢查功能	/zh-TW/docs/Web/HTML/Global_attributes/spellcheck
/zh-TW/docs/新增消息來源閱讀工具	/zh-TW/docs/Mozilla/Firefox/Releases/2/Adding_feed_readers_to_Firefox
/zh-TW/docs/本地化	/zh-TW/docs/Glossary/Localization
/zh-TW/docs/自網頁添加搜尋引擎	/zh-TW/docs/Web/API/Window/sidebar/Adding_search_engines_from_Web_pages
/zh-TW/docs/製作_Firefox_佈景主題:UUID	/zh-TW/docs/製作_Firefox_佈景主題/UUID
/zh-TW/docs/製作_Firefox_佈景主題:contents.rdf	/zh-TW/docs/製作_Firefox_佈景主題/contents.rdf
/zh-TW/docs/製作_Firefox_佈景主題:install.rdf	/zh-TW/docs/製作_Firefox_佈景主題/install.rdf
/zh-TW/docs/製作_Firefox_佈景主題:上手篇	/zh-TW/docs/製作_Firefox_佈景主題/上手篇
/zh-TW/docs/製作_OpenSearch_搜尋模組	/zh-TW/docs/Web/OpenSearch
/zh-TW/docs/調整列表縮排	/zh-TW/docs/Web/CSS/CSS_Lists_and_Counters/Consistent_list_indentation
/zh-TW/docs/重新介紹_JavaScript	/zh-TW/docs/Web/JavaScript/A_re-introduction_to_JavaScript
/zh-TW/docs/首頁	/zh-TW/docs/Web
