# FROM-URL	TO-URL
/pt-PT/docs/AJAX	/pt-PT/docs/Web/Guide/AJAX
/pt-PT/docs/AJAX/Como_começar	/pt-pt/docs/Web/Guide/AJAX/Getting_Started
/pt-PT/docs/AJAX:Como_começar	/pt-pt/docs/Web/Guide/AJAX/Getting_Started
/pt-PT/docs/Acessibilidade	/pt-pt/docs/Web/Accessibility
/pt-PT/docs/CSS	/pt-PT/docs/Web/CSS
/pt-PT/docs/CSS/:after	/pt-pt/docs/Web/CSS/::after
/pt-PT/docs/CSS/:before	/pt-pt/docs/Web/CSS/::before
/pt-PT/docs/CSS/@font-face	/pt-PT/docs/Web/CSS/@font-face
/pt-PT/docs/CSS/@import	/pt-PT/docs/Web/CSS/@import
/pt-PT/docs/CSS/@media	/pt-PT/docs/Web/CSS/@media
/pt-PT/docs/CSS/Como_começar	/pt-pt/docs/Learn/CSS/First_steps
/pt-PT/docs/CSS/Como_começar/CSS_legível	/pt-pt/docs/orphaned/Learn/CSS/Introduction_to_CSS/Syntax
/pt-PT/docs/CSS/Como_começar/Caixas	/pt-pt/docs/Learn/CSS/Building_blocks
/pt-PT/docs/CSS/Como_começar/Cascata_e_herança	/pt-pt/docs/Learn/CSS/Building_blocks/Cascade_and_inheritance
/pt-PT/docs/CSS/Como_começar/Como_o_CSS_trabalha	/pt-pt/docs/Learn/CSS/First_steps/How_CSS_works
/pt-PT/docs/CSS/Como_começar/Conteúdo	/pt-pt/docs/Learn/CSS/Howto/Generated_content
/pt-PT/docs/CSS/Como_começar/Cor	/pt-pt/docs/orphaned/Learn/CSS/Introduction_to_CSS/Values_and_units
/pt-PT/docs/CSS/Como_começar/Dados_XML	/pt-PT/docs/Web/CSS/Como_começar/Dados_XML
/pt-PT/docs/CSS/Como_começar/Disposição	/pt-pt/docs/Learn/CSS/CSS_layout
/pt-PT/docs/CSS/Como_começar/Estilos_de_texto	/pt-pt/docs/Learn/CSS/Styling_text/Fundamentals
/pt-PT/docs/CSS/Como_começar/Gráficos_SVG	/pt-pt/docs/Web/SVG/Tutorial/SVG_and_CSS
/pt-PT/docs/CSS/Como_começar/Interfaces_de_usuário_XUL	/pt-PT/docs/Web/CSS/Como_começar/Interfaces_de_usuário_XUL
/pt-PT/docs/CSS/Como_começar/JavaScript	/pt-pt/docs/Learn/JavaScript/Client-side_web_APIs/Manipulating_documents
/pt-PT/docs/CSS/Como_começar/Listas	/pt-pt/docs/Learn/CSS/Styling_text/Styling_lists
/pt-PT/docs/CSS/Como_começar/Mídia	/pt-pt/docs/Web/Progressive_web_apps/Responsive/Media_types
/pt-PT/docs/CSS/Como_começar/O_que_é_CSS	/pt-pt/docs/conflicting/Learn/CSS/First_steps/How_CSS_works
/pt-PT/docs/CSS/Como_começar/O_que_é_CSS?	/pt-pt/docs/orphaned/Web/CSS/Como_começar/O_que_é_CSS?
/pt-PT/docs/CSS/Como_começar/Porque_usar_CSS	/pt-pt/docs/conflicting/Learn/CSS/First_steps/How_CSS_works_0767812f50daab83155d62da97c6e460
/pt-PT/docs/CSS/Como_começar/Seletores	/pt-pt/docs/Learn/CSS/Building_blocks/Selectors
/pt-PT/docs/CSS/Como_começar/Tabelas	/pt-pt/docs/Learn/CSS/Building_blocks/Styling_tables
/pt-PT/docs/CSS/Consulta_de_mídia	/pt-pt/docs/Web/CSS/Media_Queries/Using_media_queries
/pt-PT/docs/CSS/Getting_Started/JavaScript	/pt-pt/docs/Learn/JavaScript/Client-side_web_APIs/Manipulating_documents
/pt-PT/docs/CSS/Múltiplos_fundos	/pt-pt/docs/Web/CSS/CSS_Backgrounds_and_Borders/Using_multiple_backgrounds
/pt-PT/docs/CSS/Múltiplos_planos_de_fundo	/pt-pt/docs/Web/CSS/CSS_Backgrounds_and_Borders/Using_multiple_backgrounds
/pt-PT/docs/CSS/Usando_transformações_CSS	/pt-pt/docs/Web/CSS/CSS_Transforms/Using_CSS_transforms
/pt-PT/docs/CSS/azimuth	/pt-PT/docs/Web/CSS/azimuth
/pt-PT/docs/CSS/background	/pt-PT/docs/Web/CSS/background
/pt-PT/docs/CSS/background-attachment	/pt-PT/docs/Web/CSS/background-attachment
/pt-PT/docs/CSS/background-color	/pt-PT/docs/Web/CSS/background-color
/pt-PT/docs/CSS/background-image	/pt-PT/docs/Web/CSS/background-image
/pt-PT/docs/CSS/background-position	/pt-PT/docs/Web/CSS/background-position
/pt-PT/docs/CSS/background-repeat	/pt-PT/docs/Web/CSS/background-repeat
/pt-PT/docs/CSS/border	/pt-PT/docs/Web/CSS/border
/pt-PT/docs/CSS/border-bottom	/pt-PT/docs/Web/CSS/border-bottom
/pt-PT/docs/CSS/border-bottom-color	/pt-PT/docs/Web/CSS/border-bottom-color
/pt-PT/docs/CSS/border-bottom-style	/pt-PT/docs/Web/CSS/border-bottom-style
/pt-PT/docs/CSS/border-bottom-width	/pt-PT/docs/Web/CSS/border-bottom-width
/pt-PT/docs/CSS/border-collapse	/pt-PT/docs/Web/CSS/border-collapse
/pt-PT/docs/CSS/border-color	/pt-PT/docs/Web/CSS/border-color
/pt-PT/docs/CSS/border-left	/pt-PT/docs/Web/CSS/border-left
/pt-PT/docs/CSS/border-left-color	/pt-PT/docs/Web/CSS/border-left-color
/pt-PT/docs/CSS/border-left-style	/pt-PT/docs/Web/CSS/border-left-style
/pt-PT/docs/CSS/border-left-width	/pt-PT/docs/Web/CSS/border-left-width
/pt-PT/docs/CSS/border-right	/pt-PT/docs/Web/CSS/border-right
/pt-PT/docs/CSS/border-right-color	/pt-PT/docs/Web/CSS/border-right-color
/pt-PT/docs/CSS/border-right-style	/pt-PT/docs/Web/CSS/border-right-style
/pt-PT/docs/CSS/border-right-width	/pt-PT/docs/Web/CSS/border-right-width
/pt-PT/docs/CSS/border-spacing	/pt-PT/docs/Web/CSS/border-spacing
/pt-PT/docs/CSS/border-top	/pt-PT/docs/Web/CSS/border-top
/pt-PT/docs/CSS/border-top-color	/pt-PT/docs/Web/CSS/border-top-color
/pt-PT/docs/CSS/border-top-style	/pt-PT/docs/Web/CSS/border-top-style
/pt-PT/docs/CSS/border-top-width	/pt-PT/docs/Web/CSS/border-top-width
/pt-PT/docs/CSS/border-width	/pt-PT/docs/Web/CSS/border-width
/pt-PT/docs/CSS/bottom	/pt-PT/docs/Web/CSS/bottom
/pt-PT/docs/CSS/clear	/pt-PT/docs/Web/CSS/clear
/pt-PT/docs/CSS/color	/pt-PT/docs/Web/CSS/color
/pt-PT/docs/CSS/content	/pt-PT/docs/Web/CSS/content
/pt-PT/docs/CSS/counter-increment	/pt-PT/docs/Web/CSS/counter-increment
/pt-PT/docs/CSS/counter-reset	/pt-PT/docs/Web/CSS/counter-reset
/pt-PT/docs/CSS/cursor	/pt-PT/docs/Web/CSS/cursor
/pt-PT/docs/CSS/direction	/pt-PT/docs/Web/CSS/direction
/pt-PT/docs/CSS/display	/pt-PT/docs/Web/CSS/display
/pt-PT/docs/CSS/float	/pt-PT/docs/Web/CSS/float
/pt-PT/docs/CSS/font	/pt-PT/docs/Web/CSS/font
/pt-PT/docs/CSS/font-size	/pt-PT/docs/Web/CSS/font-size
/pt-PT/docs/CSS/font-size-adjust	/pt-PT/docs/Web/CSS/font-size-adjust
/pt-PT/docs/CSS/font-style	/pt-PT/docs/Web/CSS/font-style
/pt-PT/docs/CSS/font-weight	/pt-PT/docs/Web/CSS/font-weight
/pt-PT/docs/CSS/height	/pt-PT/docs/Web/CSS/height
/pt-PT/docs/CSS/inherit	/pt-PT/docs/Web/CSS/inherit
/pt-PT/docs/CSS/list-style	/pt-PT/docs/Web/CSS/list-style
/pt-PT/docs/CSS/top	/pt-PT/docs/Web/CSS/top
/pt-PT/docs/CSS/width	/pt-PT/docs/Web/CSS/width
/pt-PT/docs/CSS/z-index	/pt-PT/docs/Web/CSS/z-index
/pt-PT/docs/CSS::after	/pt-pt/docs/Web/CSS/::after
/pt-PT/docs/CSS::before	/pt-pt/docs/Web/CSS/::before
/pt-PT/docs/CSS:@import	/pt-PT/docs/Web/CSS/@import
/pt-PT/docs/CSS:@media	/pt-PT/docs/Web/CSS/@media
/pt-PT/docs/CSS:Como_começar	/pt-pt/docs/Learn/CSS/First_steps
/pt-PT/docs/CSS:Como_começar:CSS_legível	/pt-pt/docs/orphaned/Learn/CSS/Introduction_to_CSS/Syntax
/pt-PT/docs/CSS:Como_começar:Caixas	/pt-pt/docs/Learn/CSS/Building_blocks
/pt-PT/docs/CSS:Como_começar:Cascata_e_herança	/pt-pt/docs/Learn/CSS/Building_blocks/Cascade_and_inheritance
/pt-PT/docs/CSS:Como_começar:Como_o_CSS_trabalha	/pt-pt/docs/Learn/CSS/First_steps/How_CSS_works
/pt-PT/docs/CSS:Como_começar:Conteúdo	/pt-pt/docs/Learn/CSS/Howto/Generated_content
/pt-PT/docs/CSS:Como_começar:Cor	/pt-pt/docs/orphaned/Learn/CSS/Introduction_to_CSS/Values_and_units
/pt-PT/docs/CSS:Como_começar:Dados_XML	/pt-PT/docs/Web/CSS/Como_começar/Dados_XML
/pt-PT/docs/CSS:Como_começar:Disposição	/pt-pt/docs/Learn/CSS/CSS_layout
/pt-PT/docs/CSS:Como_começar:Estilos_de_texto	/pt-pt/docs/Learn/CSS/Styling_text/Fundamentals
/pt-PT/docs/CSS:Como_começar:Gráficos_SVG	/pt-pt/docs/Web/SVG/Tutorial/SVG_and_CSS
/pt-PT/docs/CSS:Como_começar:Interfaces_de_usuário_XUL	/pt-PT/docs/Web/CSS/Como_começar/Interfaces_de_usuário_XUL
/pt-PT/docs/CSS:Como_começar:JavaScript	/pt-pt/docs/Learn/JavaScript/Client-side_web_APIs/Manipulating_documents
/pt-PT/docs/CSS:Como_começar:Listas	/pt-pt/docs/Learn/CSS/Styling_text/Styling_lists
/pt-PT/docs/CSS:Como_começar:Mídia	/pt-pt/docs/Web/Progressive_web_apps/Responsive/Media_types
/pt-PT/docs/CSS:Como_começar:O_que_é_CSS	/pt-pt/docs/conflicting/Learn/CSS/First_steps/How_CSS_works
/pt-PT/docs/CSS:Como_começar:O_que_é_CSS?	/pt-pt/docs/orphaned/Web/CSS/Como_começar/O_que_é_CSS?
/pt-PT/docs/CSS:Como_começar:Porque_usar_CSS	/pt-pt/docs/conflicting/Learn/CSS/First_steps/How_CSS_works_0767812f50daab83155d62da97c6e460
/pt-PT/docs/CSS:Como_começar:Seletores	/pt-pt/docs/Learn/CSS/Building_blocks/Selectors
/pt-PT/docs/CSS:Como_começar:Tabelas	/pt-pt/docs/Learn/CSS/Building_blocks/Styling_tables
/pt-PT/docs/CSS:azimuth	/pt-PT/docs/Web/CSS/azimuth
/pt-PT/docs/CSS:background	/pt-PT/docs/Web/CSS/background
/pt-PT/docs/CSS:background-attachment	/pt-PT/docs/Web/CSS/background-attachment
/pt-PT/docs/CSS:background-color	/pt-PT/docs/Web/CSS/background-color
/pt-PT/docs/CSS:background-image	/pt-PT/docs/Web/CSS/background-image
/pt-PT/docs/CSS:background-position	/pt-PT/docs/Web/CSS/background-position
/pt-PT/docs/CSS:background-repeat	/pt-PT/docs/Web/CSS/background-repeat
/pt-PT/docs/CSS:border	/pt-PT/docs/Web/CSS/border
/pt-PT/docs/CSS:border-bottom	/pt-PT/docs/Web/CSS/border-bottom
/pt-PT/docs/CSS:border-bottom-color	/pt-PT/docs/Web/CSS/border-bottom-color
/pt-PT/docs/CSS:border-bottom-style	/pt-PT/docs/Web/CSS/border-bottom-style
/pt-PT/docs/CSS:border-bottom-width	/pt-PT/docs/Web/CSS/border-bottom-width
/pt-PT/docs/CSS:border-collapse	/pt-PT/docs/Web/CSS/border-collapse
/pt-PT/docs/CSS:border-color	/pt-PT/docs/Web/CSS/border-color
/pt-PT/docs/CSS:border-left	/pt-PT/docs/Web/CSS/border-left
/pt-PT/docs/CSS:border-left-color	/pt-PT/docs/Web/CSS/border-left-color
/pt-PT/docs/CSS:border-left-style	/pt-PT/docs/Web/CSS/border-left-style
/pt-PT/docs/CSS:border-left-width	/pt-PT/docs/Web/CSS/border-left-width
/pt-PT/docs/CSS:border-right	/pt-PT/docs/Web/CSS/border-right
/pt-PT/docs/CSS:border-right-color	/pt-PT/docs/Web/CSS/border-right-color
/pt-PT/docs/CSS:border-right-style	/pt-PT/docs/Web/CSS/border-right-style
/pt-PT/docs/CSS:border-right-width	/pt-PT/docs/Web/CSS/border-right-width
/pt-PT/docs/CSS:border-spacing	/pt-PT/docs/Web/CSS/border-spacing
/pt-PT/docs/CSS:border-top	/pt-PT/docs/Web/CSS/border-top
/pt-PT/docs/CSS:border-top-color	/pt-PT/docs/Web/CSS/border-top-color
/pt-PT/docs/CSS:border-top-style	/pt-PT/docs/Web/CSS/border-top-style
/pt-PT/docs/CSS:border-top-width	/pt-PT/docs/Web/CSS/border-top-width
/pt-PT/docs/CSS:border-width	/pt-PT/docs/Web/CSS/border-width
/pt-PT/docs/CSS:bottom	/pt-PT/docs/Web/CSS/bottom
/pt-PT/docs/CSS:clear	/pt-PT/docs/Web/CSS/clear
/pt-PT/docs/CSS:color	/pt-PT/docs/Web/CSS/color
/pt-PT/docs/CSS:counter-increment	/pt-PT/docs/Web/CSS/counter-increment
/pt-PT/docs/CSS:counter-reset	/pt-PT/docs/Web/CSS/counter-reset
/pt-PT/docs/CSS:cursor	/pt-PT/docs/Web/CSS/cursor
/pt-PT/docs/CSS:direction	/pt-PT/docs/Web/CSS/direction
/pt-PT/docs/CSS:display	/pt-PT/docs/Web/CSS/display
/pt-PT/docs/CSS:float	/pt-PT/docs/Web/CSS/float
/pt-PT/docs/CSS:font	/pt-PT/docs/Web/CSS/font
/pt-PT/docs/CSS:font-size	/pt-PT/docs/Web/CSS/font-size
/pt-PT/docs/CSS:font-size-adjust	/pt-PT/docs/Web/CSS/font-size-adjust
/pt-PT/docs/CSS:font-style	/pt-PT/docs/Web/CSS/font-style
/pt-PT/docs/CSS:font-weight	/pt-PT/docs/Web/CSS/font-weight
/pt-PT/docs/CSS:height	/pt-PT/docs/Web/CSS/height
/pt-PT/docs/CSS:inherit	/pt-PT/docs/Web/CSS/inherit
/pt-PT/docs/CSS:list-style	/pt-PT/docs/Web/CSS/list-style
/pt-PT/docs/CSS:width	/pt-PT/docs/Web/CSS/width
/pt-PT/docs/CSS:z-index	/pt-PT/docs/Web/CSS/z-index
/pt-PT/docs/Compressão_de_Temas	/pt-PT/docs/Empacotando_Temas
/pt-PT/docs/Controles_Customizados	/pt-pt/docs/orphaned/XForms/Controles_Customizados
/pt-PT/docs/Criando_um_visual_para_o_Firefox:Iniciando	/pt-PT/docs/Criando_um_visual_para_o_Firefox/Iniciando
/pt-PT/docs/Criando_um_visual_para_o_Firefox:UUID	/pt-PT/docs/Criando_um_visual_para_o_Firefox/UUID
/pt-PT/docs/Criando_um_visual_para_o_Firefox:contents.rdf	/pt-PT/docs/Criando_um_visual_para_o_Firefox/contents.rdf
/pt-PT/docs/Criando_um_visual_para_o_Firefox:install.rdf	/pt-PT/docs/Criando_um_visual_para_o_Firefox/install.rdf
/pt-PT/docs/DOM	/pt-pt/docs/Web/API/Document_Object_Model
/pt-PT/docs/DOM/DOM_Reference	/pt-pt/docs/Web/API/Document_Object_Model
/pt-PT/docs/DOM/DOM_Storage	/pt-pt/docs/Web/API/Web_Storage_API
/pt-PT/docs/DOM/Storage	/pt-pt/docs/Web/API/Web_Storage_API
/pt-PT/docs/DOM/document.getElementsByClassName	/pt-pt/docs/Web/API/Document/getElementsByClassName
/pt-PT/docs/DOM/element	/pt-pt/docs/Web/API/Element
/pt-PT/docs/DOM/element.appendChild	/pt-pt/docs/Web/API/Node/appendChild
/pt-PT/docs/DOM/element.clientLeft	/pt-pt/docs/Web/API/Element/clientLeft
/pt-PT/docs/DOM/element.clientTop	/pt-pt/docs/Web/API/Element/clientTop
/pt-PT/docs/DOM/element.cloneNode	/pt-pt/docs/Web/API/Node/cloneNode
/pt-PT/docs/DOM/element.insertBefore	/pt-pt/docs/Web/API/Node/insertBefore
/pt-PT/docs/DOM:document.getElementsByClassName	/pt-pt/docs/Web/API/Document/getElementsByClassName
/pt-PT/docs/DOM:element	/pt-pt/docs/Web/API/Element
/pt-PT/docs/DOM:element.appendChild	/pt-pt/docs/Web/API/Node/appendChild
/pt-PT/docs/DOM:element.clientLeft	/pt-pt/docs/Web/API/Element/clientLeft
/pt-PT/docs/DOM:element.clientTop	/pt-pt/docs/Web/API/Element/clientTop
/pt-PT/docs/DOM:element.cloneNode	/pt-pt/docs/Web/API/Node/cloneNode
/pt-PT/docs/DOM:element.insertBefore	/pt-pt/docs/Web/API/Node/insertBefore
/pt-PT/docs/Desenvolver_Mozilla	/pt-pt/docs/Mozilla/Developer_guide
/pt-PT/docs/Desenvolvimento_Mozilla	/pt-pt/docs/Mozilla/Developer_guide
/pt-PT/docs/Desenvolvimento_Web	/pt-PT/docs/Web/Guide
/pt-PT/docs/Eventos_online_e_offline	/pt-pt/docs/Web/API/NavigatorOnLine/Online_and_offline_events
/pt-PT/docs/Folhas_de_estilo_alternativas	/pt-pt/docs/Web/CSS/Alternative_style_sheets
/pt-PT/docs/Guia_do_desenvolvedor	/pt-pt/docs/Mozilla/Developer_guide
/pt-PT/docs/HTML	/pt-PT/docs/Web/HTML
/pt-PT/docs/HTML/Aplicar_cor__elementos_HTML_utilizando_CSS	/pt-pt/docs/Web/HTML/Applying_color
/pt-PT/docs/HTML/Atributos	/pt-pt/docs/Web/HTML/Attributes
/pt-PT/docs/HTML/Atributos_globais	/pt-pt/docs/Web/HTML/Global_attributes
/pt-PT/docs/HTML/Element	/pt-pt/docs/Web/HTML/Element
/pt-PT/docs/HTML/Element/Audio	/pt-pt/docs/Web/HTML/Element/audio
/pt-PT/docs/HTML/Element/figcaption	/pt-pt/docs/Web/HTML/Element/figcaption
/pt-PT/docs/HTML/Element/figure	/pt-pt/docs/Web/HTML/Element/figure
/pt-PT/docs/HTML/Element/progress	/pt-pt/docs/Web/HTML/Element/progress
/pt-PT/docs/HTML/Elemento	/pt-pt/docs/Web/HTML/Element
/pt-PT/docs/HTML/Elemento/Audio	/pt-pt/docs/Web/HTML/Element/audio
/pt-PT/docs/HTML/Elemento/Video	/pt-pt/docs/Web/HTML/Element/video
/pt-PT/docs/HTML/Elemento/figcaption	/pt-pt/docs/Web/HTML/Element/figcaption
/pt-PT/docs/HTML/Elemento/head	/pt-pt/docs/Web/HTML/Element/head
/pt-PT/docs/HTML/Elemento/nav	/pt-pt/docs/Web/HTML/Element/nav
/pt-PT/docs/HTML/Elemento/progress	/pt-pt/docs/Web/HTML/Element/progress
/pt-PT/docs/HTML/Elemento/progress/progress	/pt-pt/docs/Web/HTML/Element/progress
/pt-PT/docs/HTML/HTML5	/pt-pt/docs/Web/Guide/HTML/HTML5
/pt-PT/docs/HTML/HTML5/Forms_no_HTML5	/pt-pt/docs/orphaned/Learn/HTML/Forms/HTML5_updates
/pt-PT/docs/HTML/HTML5/Introdução_ao_HTML5	/pt-pt/docs/Web/Guide/HTML/HTML5/Introduction_to_HTML5
/pt-PT/docs/HTML/HTML5/Parser_HTML5	/pt-pt/docs/Web/Guide/HTML/HTML5/HTML5_Parser
/pt-PT/docs/HTML/Referencia	/pt-pt/docs/Web/HTML/Reference
/pt-PT/docs/HTML/Tipos_de_hiperligacao	/pt-pt/docs/Web/HTML/Link_types
/pt-PT/docs/HTMLToDelete	/en-US/docs/Web/HTML
/pt-PT/docs/HTMLToDelete/Aplicar_cor__elementos_HTML_utilizando_CSS	/pt-pt/docs/Web/HTML/Applying_color
/pt-PT/docs/HTMLToDelete/Atributos	/pt-pt/docs/Web/HTML/Attributes
/pt-PT/docs/HTMLToDelete/Atributos_globais	/pt-pt/docs/Web/HTML/Global_attributes
/pt-PT/docs/HTMLToDelete/Element	/pt-pt/docs/Web/HTML/Element
/pt-PT/docs/HTMLToDelete/Element/Audio	/pt-pt/docs/Web/HTML/Element/audio
/pt-PT/docs/HTMLToDelete/Element/figure	/pt-pt/docs/Web/HTML/Element/figure
/pt-PT/docs/HTMLToDelete/Element/progress	/pt-pt/docs/Web/HTML/Element/progress
/pt-PT/docs/HTMLToDelete/Elemento	/pt-pt/docs/Web/HTML/Element
/pt-PT/docs/HTMLToDelete/Elemento/Audio	/pt-pt/docs/Web/HTML/Element/audio
/pt-PT/docs/HTMLToDelete/Elemento/Video	/pt-pt/docs/Web/HTML/Element/video
/pt-PT/docs/HTMLToDelete/Elemento/figcaption	/pt-pt/docs/Web/HTML/Element/figcaption
/pt-PT/docs/HTMLToDelete/Elemento/head	/pt-pt/docs/Web/HTML/Element/head
/pt-PT/docs/HTMLToDelete/Elemento/nav	/pt-pt/docs/Web/HTML/Element/nav
/pt-PT/docs/HTMLToDelete/Elemento/progress	/pt-pt/docs/Web/HTML/Element/progress
/pt-PT/docs/HTMLToDelete/Referencia	/pt-pt/docs/Web/HTML/Reference
/pt-PT/docs/HTMLToDelete/Tipos_de_hiperligacao	/pt-pt/docs/Web/HTML/Link_types
/pt-PT/docs/Introducao_a_XML	/pt-pt/docs/Web/XML/XML_introduction
/pt-PT/docs/JavaScript	/pt-PT/docs/Web/JavaScript
/pt-PT/docs/JavaScript/Guia	/pt-pt/docs/Web/JavaScript/Guide
/pt-PT/docs/JavaScript/Guia/Expressoes_e_Operadores	/pt-pt/docs/orphaned/Web/JavaScript/Guia/Expressoes_e_Operadores
/pt-PT/docs/JavaScript/Guia/Introdução_ao_JavaScript	/pt-pt/docs/orphaned/Web/JavaScript/Guia/Introdução_ao_JavaScript
/pt-PT/docs/JavaScript/Guia/Sobre	/pt-pt/docs/orphaned/Web/JavaScript/Guia/Sobre
/pt-PT/docs/JavaScript/Guia/Valores,_Variáveis_e_Literais	/pt-pt/docs/orphaned/Web/JavaScript/Guia/Valores,_Variáveis_e_Literais
/pt-PT/docs/JavaScript/Novidades_no_JavaScript	/pt-PT/docs/Web/JavaScript/Novidades_no_JavaScript
/pt-PT/docs/JavaScript/Novidades_no_JavaScript/Novidades_no_Javascript_1.8	/pt-PT/docs/Web/JavaScript/Novidades_no_JavaScript/Novidades_no_Javascript_1.8
/pt-PT/docs/JavaScript/O_que_é_o_JavaScript	/pt-pt/docs/orphaned/Web/JavaScript/O_que_é_o_JavaScript
/pt-PT/docs/JavaScript/Referência/About	/en-US/docs/Web/JavaScript/Reference/About
/pt-PT/docs/JavaScript/Referência/Code_comments	/en-US/docs/Web/JavaScript/Reference/Lexical_grammar#Comments
/pt-PT/docs/JavaScript/Referência/Deprecated_and_obsolete_features	/en-US/docs/Web/JavaScript/Reference/Deprecated_and_obsolete_features
/pt-PT/docs/JavaScript/Referência/Functions_and_function_scope	/en-US/docs/Web/JavaScript/Reference/Functions
/pt-PT/docs/JavaScript/Referência/Functions_and_function_scope/arguments	/en-US/docs/Web/JavaScript/Reference/Functions/arguments
/pt-PT/docs/JavaScript/Referência/Functions_and_function_scope/arguments/callee	/en-US/docs/Web/JavaScript/Reference/Functions/arguments/callee
/pt-PT/docs/JavaScript/Referência/Functions_and_function_scope/arguments/length	/en-US/docs/Web/JavaScript/Reference/Functions/arguments/length
/pt-PT/docs/JavaScript/Referência/Global_Objects	/en-US/docs/Web/JavaScript/Reference/Global_Objects
/pt-PT/docs/JavaScript/Referência/Global_Objects/Array	/en-US/docs/Web/JavaScript/Reference/Global_Objects/Array
/pt-PT/docs/JavaScript/Referência/Global_Objects/Array/Reduce	/en-US/docs/Web/JavaScript/Reference/Global_Objects/Array/Reduce
/pt-PT/docs/JavaScript/Referência/Global_Objects/Array/ReduceRight	/en-US/docs/Web/JavaScript/Reference/Global_Objects/Array/ReduceRight
/pt-PT/docs/JavaScript/Referência/Global_Objects/Array/concat	/en-US/docs/Web/JavaScript/Reference/Global_Objects/Array/concat
/pt-PT/docs/JavaScript/Referência/Global_Objects/Array/constructor	/en-US/docs/Web/JavaScript/Reference/Global_Objects/Array
/pt-PT/docs/JavaScript/Referência/Global_Objects/Array/every	/en-US/docs/Web/JavaScript/Reference/Global_Objects/Array/every
/pt-PT/docs/JavaScript/Referência/Global_Objects/Array/filter	/en-US/docs/Web/JavaScript/Reference/Global_Objects/Array/filter
/pt-PT/docs/JavaScript/Referência/Global_Objects/Array/forEach	/en-US/docs/Web/JavaScript/Reference/Global_Objects/Array/forEach
/pt-PT/docs/JavaScript/Referência/Global_Objects/Array/indexOf	/en-US/docs/Web/JavaScript/Reference/Global_Objects/Array/indexOf
/pt-PT/docs/JavaScript/Referência/Global_Objects/Array/isArray	/en-US/docs/Web/JavaScript/Reference/Global_Objects/Array/isArray
/pt-PT/docs/JavaScript/Referência/Global_Objects/Array/join	/en-US/docs/Web/JavaScript/Reference/Global_Objects/Array/join
/pt-PT/docs/JavaScript/Referência/Global_Objects/Array/lastIndexOf	/en-US/docs/Web/JavaScript/Reference/Global_Objects/Array/lastIndexOf
/pt-PT/docs/JavaScript/Referência/Global_Objects/Array/length	/en-US/docs/Web/JavaScript/Reference/Global_Objects/Array/length
/pt-PT/docs/JavaScript/Referência/Global_Objects/Array/map	/en-US/docs/Web/JavaScript/Reference/Global_Objects/Array/map
/pt-PT/docs/JavaScript/Referência/Global_Objects/Array/pop	/en-US/docs/Web/JavaScript/Reference/Global_Objects/Array/pop
/pt-PT/docs/JavaScript/Referência/Global_Objects/Array/push	/en-US/docs/Web/JavaScript/Reference/Global_Objects/Array/push
/pt-PT/docs/JavaScript/Referência/Global_Objects/Array/reverse	/en-US/docs/Web/JavaScript/Reference/Global_Objects/Array/reverse
/pt-PT/docs/JavaScript/Referência/Global_Objects/Array/shift	/en-US/docs/Web/JavaScript/Reference/Global_Objects/Array/shift
/pt-PT/docs/JavaScript/Referência/Global_Objects/Array/slice	/en-US/docs/Web/JavaScript/Reference/Global_Objects/Array/slice
/pt-PT/docs/JavaScript/Referência/Global_Objects/Array/some	/en-US/docs/Web/JavaScript/Reference/Global_Objects/Array/some
/pt-PT/docs/JavaScript/Referência/Global_Objects/Array/sort	/en-US/docs/Web/JavaScript/Reference/Global_Objects/Array/sort
/pt-PT/docs/JavaScript/Referência/Global_Objects/Array/splice	/en-US/docs/Web/JavaScript/Reference/Global_Objects/Array/splice
/pt-PT/docs/JavaScript/Referência/Global_Objects/Array/toSource	/en-US/docs/Web/JavaScript/Reference/Global_Objects/Array/toSource
/pt-PT/docs/JavaScript/Referência/Global_Objects/Array/toString	/en-US/docs/Web/JavaScript/Reference/Global_Objects/Array/toString
/pt-PT/docs/JavaScript/Referência/Global_Objects/Array/unshift	/en-US/docs/Web/JavaScript/Reference/Global_Objects/Array/unshift
/pt-PT/docs/JavaScript/Referência/Global_Objects/Boolean	/en-US/docs/Web/JavaScript/Reference/Global_Objects/Boolean
/pt-PT/docs/JavaScript/Referência/Global_Objects/Boolean/constructor	/en-US/docs/Web/JavaScript/Reference/Global_Objects/Boolean
/pt-PT/docs/JavaScript/Referência/Global_Objects/Boolean/prototype	/en-US/docs/Web/JavaScript/Reference/Global_Objects/Boolean
/pt-PT/docs/JavaScript/Referência/Global_Objects/Boolean/toSource	/en-US/docs/Web/JavaScript/Reference/Global_Objects/Boolean/toSource
/pt-PT/docs/JavaScript/Referência/Global_Objects/Boolean/toString	/en-US/docs/Web/JavaScript/Reference/Global_Objects/Boolean/toString
/pt-PT/docs/JavaScript/Referência/Global_Objects/Boolean/valueOf	/en-US/docs/Web/JavaScript/Reference/Global_Objects/Boolean/valueOf
/pt-PT/docs/JavaScript/Referência/Global_Objects/Date	/en-US/docs/Web/JavaScript/Reference/Global_Objects/Date
/pt-PT/docs/JavaScript/Referência/Global_Objects/Date/UTC	/en-US/docs/Web/JavaScript/Reference/Global_Objects/Date/UTC
/pt-PT/docs/JavaScript/Referência/Global_Objects/Date/constructor	/en-US/docs/Web/JavaScript/Reference/Global_Objects/Date
/pt-PT/docs/JavaScript/Referência/Global_Objects/Date/getDate	/en-US/docs/Web/JavaScript/Reference/Global_Objects/Date/getDate
/pt-PT/docs/JavaScript/Referência/Global_Objects/Date/getDay	/en-US/docs/Web/JavaScript/Reference/Global_Objects/Date/getDay
/pt-PT/docs/JavaScript/Referência/Global_Objects/Date/getFullYear	/en-US/docs/Web/JavaScript/Reference/Global_Objects/Date/getFullYear
/pt-PT/docs/JavaScript/Referência/Global_Objects/Date/getHours	/en-US/docs/Web/JavaScript/Reference/Global_Objects/Date/getHours
/pt-PT/docs/JavaScript/Referência/Global_Objects/Date/getMilliseconds	/en-US/docs/Web/JavaScript/Reference/Global_Objects/Date/getMilliseconds
/pt-PT/docs/JavaScript/Referência/Global_Objects/Date/getMinutes	/en-US/docs/Web/JavaScript/Reference/Global_Objects/Date/getMinutes
/pt-PT/docs/JavaScript/Referência/Global_Objects/Date/getMonth	/en-US/docs/Web/JavaScript/Reference/Global_Objects/Date/getMonth
/pt-PT/docs/JavaScript/Referência/Global_Objects/Date/getSeconds	/en-US/docs/Web/JavaScript/Reference/Global_Objects/Date/getSeconds
/pt-PT/docs/JavaScript/Referência/Global_Objects/Date/getTime	/en-US/docs/Web/JavaScript/Reference/Global_Objects/Date/getTime
/pt-PT/docs/JavaScript/Referência/Global_Objects/Date/getTimezoneOffset	/en-US/docs/Web/JavaScript/Reference/Global_Objects/Date/getTimezoneOffset
/pt-PT/docs/JavaScript/Referência/Global_Objects/Date/getUTCDate	/en-US/docs/Web/JavaScript/Reference/Global_Objects/Date/getUTCDate
/pt-PT/docs/JavaScript/Referência/Global_Objects/Date/getUTCDay	/en-US/docs/Web/JavaScript/Reference/Global_Objects/Date/getUTCDay
/pt-PT/docs/JavaScript/Referência/Global_Objects/Date/getUTCFullYear	/en-US/docs/Web/JavaScript/Reference/Global_Objects/Date/getUTCFullYear
/pt-PT/docs/JavaScript/Referência/Global_Objects/Date/getUTCHours	/en-US/docs/Web/JavaScript/Reference/Global_Objects/Date/getUTCHours
/pt-PT/docs/JavaScript/Referência/Global_Objects/Date/getUTCMilliseconds	/en-US/docs/Web/JavaScript/Reference/Global_Objects/Date/getUTCMilliseconds
/pt-PT/docs/JavaScript/Referência/Global_Objects/Date/getUTCMinutes	/en-US/docs/Web/JavaScript/Reference/Global_Objects/Date/getUTCMinutes
/pt-PT/docs/JavaScript/Referência/Global_Objects/Date/getUTCMonth	/en-US/docs/Web/JavaScript/Reference/Global_Objects/Date/getUTCMonth
/pt-PT/docs/JavaScript/Referência/Global_Objects/Date/getUTCSeconds	/en-US/docs/Web/JavaScript/Reference/Global_Objects/Date/getUTCSeconds
/pt-PT/docs/JavaScript/Referência/Global_Objects/Date/getYear	/en-US/docs/Web/JavaScript/Reference/Global_Objects/Date/getYear
/pt-PT/docs/JavaScript/Referência/Global_Objects/Date/now	/en-US/docs/Web/JavaScript/Reference/Global_Objects/Date/now
/pt-PT/docs/JavaScript/Referência/Global_Objects/Date/parse	/en-US/docs/Web/JavaScript/Reference/Global_Objects/Date/parse
/pt-PT/docs/JavaScript/Referência/Global_Objects/Date/prototype	/en-US/docs/Web/JavaScript/Reference/Global_Objects/Date
/pt-PT/docs/JavaScript/Referência/Global_Objects/Date/setDate	/en-US/docs/Web/JavaScript/Reference/Global_Objects/Date/setDate
/pt-PT/docs/JavaScript/Referência/Global_Objects/Date/setFullYear	/en-US/docs/Web/JavaScript/Reference/Global_Objects/Date/setFullYear
/pt-PT/docs/JavaScript/Referência/Global_Objects/Date/setHours	/en-US/docs/Web/JavaScript/Reference/Global_Objects/Date/setHours
/pt-PT/docs/JavaScript/Referência/Global_Objects/Date/setMilliseconds	/en-US/docs/Web/JavaScript/Reference/Global_Objects/Date/setMilliseconds
/pt-PT/docs/JavaScript/Referência/Global_Objects/Date/setMinutes	/en-US/docs/Web/JavaScript/Reference/Global_Objects/Date/setMinutes
/pt-PT/docs/JavaScript/Referência/Global_Objects/Date/setMonth	/en-US/docs/Web/JavaScript/Reference/Global_Objects/Date/setMonth
/pt-PT/docs/JavaScript/Referência/Global_Objects/Date/setSeconds	/en-US/docs/Web/JavaScript/Reference/Global_Objects/Date/setSeconds
/pt-PT/docs/JavaScript/Referência/Global_Objects/Date/setTime	/en-US/docs/Web/JavaScript/Reference/Global_Objects/Date/setTime
/pt-PT/docs/JavaScript/Referência/Global_Objects/Date/setUTCDate	/en-US/docs/Web/JavaScript/Reference/Global_Objects/Date/setUTCDate
/pt-PT/docs/JavaScript/Referência/Global_Objects/Date/setUTCFullYear	/en-US/docs/Web/JavaScript/Reference/Global_Objects/Date/setUTCFullYear
/pt-PT/docs/JavaScript/Referência/Global_Objects/Date/setUTCHours	/en-US/docs/Web/JavaScript/Reference/Global_Objects/Date/setUTCHours
/pt-PT/docs/JavaScript/Referência/Global_Objects/Date/setUTCMilliseconds	/en-US/docs/Web/JavaScript/Reference/Global_Objects/Date/setUTCMilliseconds
/pt-PT/docs/JavaScript/Referência/Global_Objects/Date/setUTCMinutes	/en-US/docs/Web/JavaScript/Reference/Global_Objects/Date/setUTCMinutes
/pt-PT/docs/JavaScript/Referência/Global_Objects/Date/setUTCMonth	/en-US/docs/Web/JavaScript/Reference/Global_Objects/Date/setUTCMonth
/pt-PT/docs/JavaScript/Referência/Global_Objects/Date/setUTCSeconds	/en-US/docs/Web/JavaScript/Reference/Global_Objects/Date/setUTCSeconds
/pt-PT/docs/JavaScript/Referência/Global_Objects/Date/setYear	/en-US/docs/Web/JavaScript/Reference/Global_Objects/Date/setYear
/pt-PT/docs/JavaScript/Referência/Global_Objects/Date/toDateString	/en-US/docs/Web/JavaScript/Reference/Global_Objects/Date/toDateString
/pt-PT/docs/JavaScript/Referência/Global_Objects/Date/toGMTString	/en-US/docs/Web/JavaScript/Reference/Global_Objects/Date/toGMTString
/pt-PT/docs/JavaScript/Referência/Global_Objects/Date/toISOString	/en-US/docs/Web/JavaScript/Reference/Global_Objects/Date/toISOString
/pt-PT/docs/JavaScript/Referência/Global_Objects/Date/toJSON	/en-US/docs/Web/JavaScript/Reference/Global_Objects/Date/toJSON
/pt-PT/docs/JavaScript/Referência/Global_Objects/Date/toLocaleDateString	/en-US/docs/Web/JavaScript/Reference/Global_Objects/Date/toLocaleDateString
/pt-PT/docs/JavaScript/Referência/Global_Objects/Date/toLocaleString	/en-US/docs/Web/JavaScript/Reference/Global_Objects/Date/toLocaleString
/pt-PT/docs/JavaScript/Referência/Global_Objects/Date/toLocaleTimeString	/en-US/docs/Web/JavaScript/Reference/Global_Objects/Date/toLocaleTimeString
/pt-PT/docs/JavaScript/Referência/Global_Objects/Date/toSource	/en-US/docs/Web/JavaScript/Reference/Global_Objects/Date/toSource
/pt-PT/docs/JavaScript/Referência/Global_Objects/Date/toString	/en-US/docs/Web/JavaScript/Reference/Global_Objects/Date/toString
/pt-PT/docs/JavaScript/Referência/Global_Objects/Date/toTimeString	/en-US/docs/Web/JavaScript/Reference/Global_Objects/Date/toTimeString
/pt-PT/docs/JavaScript/Referência/Global_Objects/Date/toUTCString	/en-US/docs/Web/JavaScript/Reference/Global_Objects/Date/toUTCString
/pt-PT/docs/JavaScript/Referência/Global_Objects/Date/valueOf	/en-US/docs/Web/JavaScript/Reference/Global_Objects/Date/valueOf
/pt-PT/docs/JavaScript/Referência/Global_Objects/Error	/en-US/docs/Web/JavaScript/Reference/Global_Objects/Error
/pt-PT/docs/JavaScript/Referência/Global_Objects/Error/Stack	/en-US/docs/Web/JavaScript/Reference/Global_Objects/Error/Stack
/pt-PT/docs/JavaScript/Referência/Global_Objects/Error/message	/en-US/docs/Web/JavaScript/Reference/Global_Objects/Error/message
/pt-PT/docs/JavaScript/Referência/Global_Objects/Error/name	/en-US/docs/Web/JavaScript/Reference/Global_Objects/Error/name
/pt-PT/docs/JavaScript/Referência/Global_Objects/Error/prototype	/en-US/docs/Web/JavaScript/Reference/Global_Objects/Error
/pt-PT/docs/JavaScript/Referência/Global_Objects/Error/toSource	/en-US/docs/Web/JavaScript/Reference/Global_Objects/Error/toSource
/pt-PT/docs/JavaScript/Referência/Global_Objects/Error/toString	/en-US/docs/Web/JavaScript/Reference/Global_Objects/Error/toString
/pt-PT/docs/JavaScript/Referência/Global_Objects/EvalError	/en-US/docs/Web/JavaScript/Reference/Global_Objects/EvalError
/pt-PT/docs/JavaScript/Referência/Global_Objects/EvalError/prototype	/en-US/docs/Web/JavaScript/Reference/Global_Objects/EvalError
/pt-PT/docs/JavaScript/Referência/Global_Objects/Function	/en-US/docs/Web/JavaScript/Reference/Global_Objects/Function
/pt-PT/docs/JavaScript/Referência/Global_Objects/Function/apply	/en-US/docs/Web/JavaScript/Reference/Global_Objects/Function/apply
/pt-PT/docs/JavaScript/Referência/Global_Objects/Function/arguments	/en-US/docs/Web/JavaScript/Reference/Global_Objects/Function/arguments
/pt-PT/docs/JavaScript/Referência/Global_Objects/Function/bind	/en-US/docs/Web/JavaScript/Reference/Global_Objects/Function/bind
/pt-PT/docs/JavaScript/Referência/Global_Objects/Function/call	/en-US/docs/Web/JavaScript/Reference/Global_Objects/Function/call
/pt-PT/docs/JavaScript/Referência/Global_Objects/Function/caller	/en-US/docs/Web/JavaScript/Reference/Global_Objects/Function/caller
/pt-PT/docs/JavaScript/Referência/Global_Objects/Function/constructor	/en-US/docs/Web/JavaScript/Reference/Global_Objects/Function
/pt-PT/docs/JavaScript/Referência/Global_Objects/Function/length	/en-US/docs/Web/JavaScript/Reference/Global_Objects/Function/length
/pt-PT/docs/JavaScript/Referência/Global_Objects/Function/name	/en-US/docs/Web/JavaScript/Reference/Global_Objects/Function/name
/pt-PT/docs/JavaScript/Referência/Global_Objects/Function/prototype	/en-US/docs/Web/JavaScript/Reference/Global_Objects/Function
/pt-PT/docs/JavaScript/Referência/Global_Objects/Function/toSource	/en-US/docs/Web/JavaScript/Reference/Global_Objects/Function/toSource
/pt-PT/docs/JavaScript/Referência/Global_Objects/Function/toString	/en-US/docs/Web/JavaScript/Reference/Global_Objects/Function/toString
/pt-PT/docs/JavaScript/Referência/Global_Objects/Generator	/en-US/docs/Web/JavaScript/Reference/Global_Objects/Generator
/pt-PT/docs/JavaScript/Referência/Global_Objects/Infinity	/en-US/docs/Web/JavaScript/Reference/Global_Objects/Infinity
/pt-PT/docs/JavaScript/Referência/Global_Objects/JSON	/en-US/docs/Web/JavaScript/Reference/Global_Objects/JSON
/pt-PT/docs/JavaScript/Referência/Global_Objects/JSON/parse	/en-US/docs/Web/JavaScript/Reference/Global_Objects/JSON/parse
/pt-PT/docs/JavaScript/Referência/Global_Objects/JSON/stringify	/en-US/docs/Web/JavaScript/Reference/Global_Objects/JSON/stringify
/pt-PT/docs/JavaScript/Referência/Global_Objects/Math	/en-US/docs/Web/JavaScript/Reference/Global_Objects/Math
/pt-PT/docs/JavaScript/Referência/Global_Objects/Math/E	/en-US/docs/Web/JavaScript/Reference/Global_Objects/Math/E
/pt-PT/docs/JavaScript/Referência/Global_Objects/Math/LN10	/en-US/docs/Web/JavaScript/Reference/Global_Objects/Math/LN10
/pt-PT/docs/JavaScript/Referência/Global_Objects/Math/LN2	/en-US/docs/Web/JavaScript/Reference/Global_Objects/Math/LN2
/pt-PT/docs/JavaScript/Referência/Global_Objects/Math/LOG10E	/en-US/docs/Web/JavaScript/Reference/Global_Objects/Math/LOG10E
/pt-PT/docs/JavaScript/Referência/Global_Objects/Math/LOG2E	/en-US/docs/Web/JavaScript/Reference/Global_Objects/Math/LOG2E
/pt-PT/docs/JavaScript/Referência/Global_Objects/Math/PI	/en-US/docs/Web/JavaScript/Reference/Global_Objects/Math/PI
/pt-PT/docs/JavaScript/Referência/Global_Objects/Math/SQRT1_2	/en-US/docs/Web/JavaScript/Reference/Global_Objects/Math/SQRT1_2
/pt-PT/docs/JavaScript/Referência/Global_Objects/Math/SQRT2	/en-US/docs/Web/JavaScript/Reference/Global_Objects/Math/SQRT2
/pt-PT/docs/JavaScript/Referência/Global_Objects/Math/abs	/en-US/docs/Web/JavaScript/Reference/Global_Objects/Math/abs
/pt-PT/docs/JavaScript/Referência/Global_Objects/Math/acos	/en-US/docs/Web/JavaScript/Reference/Global_Objects/Math/acos
/pt-PT/docs/JavaScript/Referência/Global_Objects/Math/asin	/en-US/docs/Web/JavaScript/Reference/Global_Objects/Math/asin
/pt-PT/docs/JavaScript/Referência/Global_Objects/Math/atan	/en-US/docs/Web/JavaScript/Reference/Global_Objects/Math/atan
/pt-PT/docs/JavaScript/Referência/Global_Objects/Math/atan2	/en-US/docs/Web/JavaScript/Reference/Global_Objects/Math/atan2
/pt-PT/docs/JavaScript/Referência/Global_Objects/Math/ceil	/en-US/docs/Web/JavaScript/Reference/Global_Objects/Math/ceil
/pt-PT/docs/JavaScript/Referência/Global_Objects/Math/cos	/en-US/docs/Web/JavaScript/Reference/Global_Objects/Math/cos
/pt-PT/docs/JavaScript/Referência/Global_Objects/Math/exp	/en-US/docs/Web/JavaScript/Reference/Global_Objects/Math/exp
/pt-PT/docs/JavaScript/Referência/Global_Objects/Math/floor	/en-US/docs/Web/JavaScript/Reference/Global_Objects/Math/floor
/pt-PT/docs/JavaScript/Referência/Global_Objects/Math/log	/en-US/docs/Web/JavaScript/Reference/Global_Objects/Math/log
/pt-PT/docs/JavaScript/Referência/Global_Objects/Math/max	/en-US/docs/Web/JavaScript/Reference/Global_Objects/Math/max
/pt-PT/docs/JavaScript/Referência/Global_Objects/Math/min	/en-US/docs/Web/JavaScript/Reference/Global_Objects/Math/min
/pt-PT/docs/JavaScript/Referência/Global_Objects/Math/pow	/en-US/docs/Web/JavaScript/Reference/Global_Objects/Math/pow
/pt-PT/docs/JavaScript/Referência/Global_Objects/Math/random	/en-US/docs/Web/JavaScript/Reference/Global_Objects/Math/random
/pt-PT/docs/JavaScript/Referência/Global_Objects/Math/round	/en-US/docs/Web/JavaScript/Reference/Global_Objects/Math/round
/pt-PT/docs/JavaScript/Referência/Global_Objects/Math/sin	/en-US/docs/Web/JavaScript/Reference/Global_Objects/Math/sin
/pt-PT/docs/JavaScript/Referência/Global_Objects/Math/sqrt	/en-US/docs/Web/JavaScript/Reference/Global_Objects/Math/sqrt
/pt-PT/docs/JavaScript/Referência/Global_Objects/Math/tan	/en-US/docs/Web/JavaScript/Reference/Global_Objects/Math/tan
/pt-PT/docs/JavaScript/Referência/Global_Objects/NaN	/en-US/docs/Web/JavaScript/Reference/Global_Objects/NaN
/pt-PT/docs/JavaScript/Referência/Global_Objects/Number	/en-US/docs/Web/JavaScript/Reference/Global_Objects/Number
/pt-PT/docs/JavaScript/Referência/Global_Objects/Number/MAX_VALUE	/en-US/docs/Web/JavaScript/Reference/Global_Objects/Number/MAX_VALUE
/pt-PT/docs/JavaScript/Referência/Global_Objects/Number/MIN_VALUE	/en-US/docs/Web/JavaScript/Reference/Global_Objects/Number/MIN_VALUE
/pt-PT/docs/JavaScript/Referência/Global_Objects/Number/NEGATIVE_INFINITY	/en-US/docs/Web/JavaScript/Reference/Global_Objects/Number/NEGATIVE_INFINITY
/pt-PT/docs/JavaScript/Referência/Global_Objects/Number/NaN	/en-US/docs/Web/JavaScript/Reference/Global_Objects/Number/NaN
/pt-PT/docs/JavaScript/Referência/Global_Objects/Number/POSITIVE_INFINITY	/en-US/docs/Web/JavaScript/Reference/Global_Objects/Number/POSITIVE_INFINITY
/pt-PT/docs/JavaScript/Referência/Global_Objects/Number/constructor	/en-US/docs/Web/JavaScript/Reference/Global_Objects/Number
/pt-PT/docs/JavaScript/Referência/Global_Objects/Number/prototype	/en-US/docs/Web/JavaScript/Reference/Global_Objects/Number
/pt-PT/docs/JavaScript/Referência/Global_Objects/Number/toExponential	/en-US/docs/Web/JavaScript/Reference/Global_Objects/Number/toExponential
/pt-PT/docs/JavaScript/Referência/Global_Objects/Number/toFixed	/en-US/docs/Web/JavaScript/Reference/Global_Objects/Number/toFixed
/pt-PT/docs/JavaScript/Referência/Global_Objects/Number/toPrecision	/en-US/docs/Web/JavaScript/Reference/Global_Objects/Number/toPrecision
/pt-PT/docs/JavaScript/Referência/Global_Objects/Number/toSource	/en-US/docs/Web/JavaScript/Reference/Global_Objects/Number/toSource
/pt-PT/docs/JavaScript/Referência/Global_Objects/Number/toString	/en-US/docs/Web/JavaScript/Reference/Global_Objects/Number/toString
/pt-PT/docs/JavaScript/Referência/Global_Objects/Number/valueOf	/en-US/docs/Web/JavaScript/Reference/Global_Objects/Number/valueOf
/pt-PT/docs/JavaScript/Referência/Global_Objects/Object	/en-US/docs/Web/JavaScript/Reference/Global_Objects/Object
/pt-PT/docs/JavaScript/Referência/Global_Objects/Object/constructor	/en-US/docs/Web/JavaScript/Reference/Global_Objects/Object/constructor
/pt-PT/docs/JavaScript/Referência/Global_Objects/Object/create	/en-US/docs/Web/JavaScript/Reference/Global_Objects/Object/create
/pt-PT/docs/JavaScript/Referência/Global_Objects/Object/defineGetter	/en-US/docs/Web/JavaScript/Reference/Global_Objects/Object/__defineGetter__
/pt-PT/docs/JavaScript/Referência/Global_Objects/Object/defineProperties	/en-US/docs/Web/JavaScript/Reference/Global_Objects/Object/defineProperties
/pt-PT/docs/JavaScript/Referência/Global_Objects/Object/defineProperty	/en-US/docs/Web/JavaScript/Reference/Global_Objects/Object/defineProperty
/pt-PT/docs/JavaScript/Referência/Global_Objects/Object/defineSetter	/en-US/docs/Web/JavaScript/Reference/Global_Objects/Object/__defineSetter__
/pt-PT/docs/JavaScript/Referência/Global_Objects/Object/freeze	/en-US/docs/Web/JavaScript/Reference/Global_Objects/Object/freeze
/pt-PT/docs/JavaScript/Referência/Global_Objects/Object/getOwnPropertyDescriptor	/en-US/docs/Web/JavaScript/Reference/Global_Objects/Object/getOwnPropertyDescriptor
/pt-PT/docs/JavaScript/Referência/Global_Objects/Object/getOwnPropertyNames	/en-US/docs/Web/JavaScript/Reference/Global_Objects/Object/getOwnPropertyNames
/pt-PT/docs/JavaScript/Referência/Global_Objects/Object/hasOwnProperty	/en-US/docs/Web/JavaScript/Reference/Global_Objects/Object/hasOwnProperty
/pt-PT/docs/JavaScript/Referência/Global_Objects/Object/isExtensible	/en-US/docs/Web/JavaScript/Reference/Global_Objects/Object/isExtensible
/pt-PT/docs/JavaScript/Referência/Global_Objects/Object/isFrozen	/en-US/docs/Web/JavaScript/Reference/Global_Objects/Object/isFrozen
/pt-PT/docs/JavaScript/Referência/Global_Objects/Object/isPrototypeOf	/en-US/docs/Web/JavaScript/Reference/Global_Objects/Object/isPrototypeOf
/pt-PT/docs/JavaScript/Referência/Global_Objects/Object/isSealed	/en-US/docs/Web/JavaScript/Reference/Global_Objects/Object/isSealed
/pt-PT/docs/JavaScript/Referência/Global_Objects/Object/keys	/en-US/docs/Web/JavaScript/Reference/Global_Objects/Object/keys
/pt-PT/docs/JavaScript/Referência/Global_Objects/Object/lookupGetter	/en-US/docs/Web/JavaScript/Reference/Global_Objects/Object/__lookupGetter__
/pt-PT/docs/JavaScript/Referência/Global_Objects/Object/lookupSetter	/en-US/docs/Web/JavaScript/Reference/Global_Objects/Object/__lookupSetter__
/pt-PT/docs/JavaScript/Referência/Global_Objects/Object/preventExtensions	/en-US/docs/Web/JavaScript/Reference/Global_Objects/Object/preventExtensions
/pt-PT/docs/JavaScript/Referência/Global_Objects/Object/propertyIsEnumerable	/en-US/docs/Web/JavaScript/Reference/Global_Objects/Object/propertyIsEnumerable
/pt-PT/docs/JavaScript/Referência/Global_Objects/Object/proto	/en-US/docs/Web/JavaScript/Reference/Global_Objects/Object/proto
/pt-PT/docs/JavaScript/Referência/Global_Objects/Object/prototype	/en-US/docs/Web/JavaScript/Reference/Global_Objects/Object
/pt-PT/docs/JavaScript/Referência/Global_Objects/Object/seal	/en-US/docs/Web/JavaScript/Reference/Global_Objects/Object/seal
/pt-PT/docs/JavaScript/Referência/Global_Objects/Object/toLocaleString	/en-US/docs/Web/JavaScript/Reference/Global_Objects/Object/toLocaleString
/pt-PT/docs/JavaScript/Referência/Global_Objects/Object/toSource	/en-US/docs/Web/JavaScript/Reference/Global_Objects/Object/toSource
/pt-PT/docs/JavaScript/Referência/Global_Objects/Object/toString	/en-US/docs/Web/JavaScript/Reference/Global_Objects/Object/toString
/pt-PT/docs/JavaScript/Referência/Global_Objects/Object/valueOf	/en-US/docs/Web/JavaScript/Reference/Global_Objects/Object/valueOf
/pt-PT/docs/JavaScript/Referência/Global_Objects/Proxy	/en-US/docs/Web/JavaScript/Reference/Global_Objects/Proxy
/pt-PT/docs/JavaScript/Referência/Global_Objects/RangeError	/en-US/docs/Web/JavaScript/Reference/Global_Objects/RangeError
/pt-PT/docs/JavaScript/Referência/Global_Objects/RangeError/prototype	/en-US/docs/Web/JavaScript/Reference/Global_Objects/RangeError
/pt-PT/docs/JavaScript/Referência/Global_Objects/ReferenceError	/en-US/docs/Web/JavaScript/Reference/Global_Objects/ReferenceError
/pt-PT/docs/JavaScript/Referência/Global_Objects/ReferenceError/prototype	/en-US/docs/Web/JavaScript/Reference/Global_Objects/ReferenceError
/pt-PT/docs/JavaScript/Referência/Global_Objects/RegExp	/en-US/docs/Web/JavaScript/Reference/Global_Objects/RegExp
/pt-PT/docs/JavaScript/Referência/Global_Objects/RegExp/constructor	/en-US/docs/Web/JavaScript/Reference/Global_Objects/RegExp
/pt-PT/docs/JavaScript/Referência/Global_Objects/RegExp/exec	/en-US/docs/Web/JavaScript/Reference/Global_Objects/RegExp/exec
/pt-PT/docs/JavaScript/Referência/Global_Objects/RegExp/global	/en-US/docs/Web/JavaScript/Reference/Global_Objects/RegExp/global
/pt-PT/docs/JavaScript/Referência/Global_Objects/RegExp/ignoreCase	/en-US/docs/Web/JavaScript/Reference/Global_Objects/RegExp/ignoreCase
/pt-PT/docs/JavaScript/Referência/Global_Objects/RegExp/lastIndex	/en-US/docs/Web/JavaScript/Reference/Global_Objects/RegExp/lastIndex
/pt-PT/docs/JavaScript/Referência/Global_Objects/RegExp/multiline	/en-US/docs/Web/JavaScript/Reference/Global_Objects/RegExp/multiline
/pt-PT/docs/JavaScript/Referência/Global_Objects/RegExp/prototype	/en-US/docs/Web/JavaScript/Reference/Global_Objects/RegExp
/pt-PT/docs/JavaScript/Referência/Global_Objects/RegExp/source	/en-US/docs/Web/JavaScript/Reference/Global_Objects/RegExp/source
/pt-PT/docs/JavaScript/Referência/Global_Objects/RegExp/test	/en-US/docs/Web/JavaScript/Reference/Global_Objects/RegExp/test
/pt-PT/docs/JavaScript/Referência/Global_Objects/RegExp/toSource	/en-US/docs/Web/JavaScript/Reference/Global_Objects/RegExp/toSource
/pt-PT/docs/JavaScript/Referência/Global_Objects/RegExp/toString	/en-US/docs/Web/JavaScript/Reference/Global_Objects/RegExp/toString
/pt-PT/docs/JavaScript/Referência/Global_Objects/String	/en-US/docs/Web/JavaScript/Reference/Global_Objects/String
/pt-PT/docs/JavaScript/Referência/Global_Objects/String/Trim	/en-US/docs/Web/JavaScript/Reference/Global_Objects/String/Trim
/pt-PT/docs/JavaScript/Referência/Global_Objects/String/TrimLeft	/en-US/docs/Web/JavaScript/Reference/Global_Objects/String/trimStart
/pt-PT/docs/JavaScript/Referência/Global_Objects/String/TrimRight	/en-US/docs/Web/JavaScript/Reference/Global_Objects/String/trimEnd
/pt-PT/docs/JavaScript/Referência/Global_Objects/String/anchor	/en-US/docs/Web/JavaScript/Reference/Global_Objects/String/anchor
/pt-PT/docs/JavaScript/Referência/Global_Objects/String/big	/en-US/docs/Web/JavaScript/Reference/Global_Objects/String/big
/pt-PT/docs/JavaScript/Referência/Global_Objects/String/blink	/en-US/docs/Web/JavaScript/Reference/Global_Objects/String/blink
/pt-PT/docs/JavaScript/Referência/Global_Objects/String/bold	/en-US/docs/Web/JavaScript/Reference/Global_Objects/String/bold
/pt-PT/docs/JavaScript/Referência/Global_Objects/String/charAt	/en-US/docs/Web/JavaScript/Reference/Global_Objects/String/charAt
/pt-PT/docs/JavaScript/Referência/Global_Objects/String/charCodeAt	/en-US/docs/Web/JavaScript/Reference/Global_Objects/String/charCodeAt
/pt-PT/docs/JavaScript/Referência/Global_Objects/String/concat	/en-US/docs/Web/JavaScript/Reference/Global_Objects/String/concat
/pt-PT/docs/JavaScript/Referência/Global_Objects/String/constructor	/en-US/docs/Web/JavaScript/Reference/Global_Objects/String
/pt-PT/docs/JavaScript/Referência/Global_Objects/String/fixed	/en-US/docs/Web/JavaScript/Reference/Global_Objects/String/fixed
/pt-PT/docs/JavaScript/Referência/Global_Objects/String/fontcolor	/en-US/docs/Web/JavaScript/Reference/Global_Objects/String/fontcolor
/pt-PT/docs/JavaScript/Referência/Global_Objects/String/fontsize	/en-US/docs/Web/JavaScript/Reference/Global_Objects/String/fontsize
/pt-PT/docs/JavaScript/Referência/Global_Objects/String/fromCharCode	/en-US/docs/Web/JavaScript/Reference/Global_Objects/String/fromCharCode
/pt-PT/docs/JavaScript/Referência/Global_Objects/String/indexOf	/en-US/docs/Web/JavaScript/Reference/Global_Objects/String/indexOf
/pt-PT/docs/JavaScript/Referência/Global_Objects/String/italics	/en-US/docs/Web/JavaScript/Reference/Global_Objects/String/italics
/pt-PT/docs/JavaScript/Referência/Global_Objects/String/lastIndexOf	/en-US/docs/Web/JavaScript/Reference/Global_Objects/String/lastIndexOf
/pt-PT/docs/JavaScript/Referência/Global_Objects/String/length	/en-US/docs/Web/JavaScript/Reference/Global_Objects/String/length
/pt-PT/docs/JavaScript/Referência/Global_Objects/String/link	/en-US/docs/Web/JavaScript/Reference/Global_Objects/String/link
/pt-PT/docs/JavaScript/Referência/Global_Objects/String/localeCompare	/en-US/docs/Web/JavaScript/Reference/Global_Objects/String/localeCompare
/pt-PT/docs/JavaScript/Referência/Global_Objects/String/match	/en-US/docs/Web/JavaScript/Reference/Global_Objects/String/match
/pt-PT/docs/JavaScript/Referência/Global_Objects/String/prototype	/en-US/docs/Web/JavaScript/Reference/Global_Objects/String
/pt-PT/docs/JavaScript/Referência/Global_Objects/String/replace	/en-US/docs/Web/JavaScript/Reference/Global_Objects/String/replace
/pt-PT/docs/JavaScript/Referência/Global_Objects/String/search	/en-US/docs/Web/JavaScript/Reference/Global_Objects/String/search
/pt-PT/docs/JavaScript/Referência/Global_Objects/String/slice	/en-US/docs/Web/JavaScript/Reference/Global_Objects/String/slice
/pt-PT/docs/JavaScript/Referência/Global_Objects/String/small	/en-US/docs/Web/JavaScript/Reference/Global_Objects/String/small
/pt-PT/docs/JavaScript/Referência/Global_Objects/String/split	/en-US/docs/Web/JavaScript/Reference/Global_Objects/String/split
/pt-PT/docs/JavaScript/Referência/Global_Objects/String/strike	/en-US/docs/Web/JavaScript/Reference/Global_Objects/String/strike
/pt-PT/docs/JavaScript/Referência/Global_Objects/String/sub	/en-US/docs/Web/JavaScript/Reference/Global_Objects/String/sub
/pt-PT/docs/JavaScript/Referência/Global_Objects/String/substr	/en-US/docs/Web/JavaScript/Reference/Global_Objects/String/substr
/pt-PT/docs/JavaScript/Referência/Global_Objects/String/substring	/en-US/docs/Web/JavaScript/Reference/Global_Objects/String/substring
/pt-PT/docs/JavaScript/Referência/Global_Objects/String/sup	/en-US/docs/Web/JavaScript/Reference/Global_Objects/String/sup
/pt-PT/docs/JavaScript/Referência/Global_Objects/String/toLocaleLowerCase	/en-US/docs/Web/JavaScript/Reference/Global_Objects/String/toLocaleLowerCase
/pt-PT/docs/JavaScript/Referência/Global_Objects/String/toLocaleUpperCase	/en-US/docs/Web/JavaScript/Reference/Global_Objects/String/toLocaleUpperCase
/pt-PT/docs/JavaScript/Referência/Global_Objects/String/toLowerCase	/en-US/docs/Web/JavaScript/Reference/Global_Objects/String/toLowerCase
/pt-PT/docs/JavaScript/Referência/Global_Objects/String/toSource	/en-US/docs/Web/JavaScript/Reference/Global_Objects/String/toSource
/pt-PT/docs/JavaScript/Referência/Global_Objects/String/toString	/en-US/docs/Web/JavaScript/Reference/Global_Objects/String/toString
/pt-PT/docs/JavaScript/Referência/Global_Objects/String/toUpperCase	/en-US/docs/Web/JavaScript/Reference/Global_Objects/String/toUpperCase
/pt-PT/docs/JavaScript/Referência/Global_Objects/String/valueOf	/en-US/docs/Web/JavaScript/Reference/Global_Objects/String/valueOf
/pt-PT/docs/JavaScript/Referência/Global_Objects/SyntaxError	/en-US/docs/Web/JavaScript/Reference/Global_Objects/SyntaxError
/pt-PT/docs/JavaScript/Referência/Global_Objects/SyntaxError/prototype	/en-US/docs/Web/JavaScript/Reference/Global_Objects/SyntaxError
/pt-PT/docs/JavaScript/Referência/Global_Objects/TypeError	/en-US/docs/Web/JavaScript/Reference/Global_Objects/TypeError
/pt-PT/docs/JavaScript/Referência/Global_Objects/TypeError/prototype	/en-US/docs/Web/JavaScript/Reference/Global_Objects/TypeError
/pt-PT/docs/JavaScript/Referência/Global_Objects/URIError	/en-US/docs/Web/JavaScript/Reference/Global_Objects/URIError
/pt-PT/docs/JavaScript/Referência/Global_Objects/URIError/prototype	/en-US/docs/Web/JavaScript/Reference/Global_Objects/URIError
/pt-PT/docs/JavaScript/Referência/Global_Objects/WeakMap	/en-US/docs/Web/JavaScript/Reference/Global_Objects/WeakMap
/pt-PT/docs/JavaScript/Referência/Global_Objects/decodeURI	/en-US/docs/Web/JavaScript/Reference/Global_Objects/decodeURI
/pt-PT/docs/JavaScript/Referência/Global_Objects/decodeURIComponent	/en-US/docs/Web/JavaScript/Reference/Global_Objects/decodeURIComponent
/pt-PT/docs/JavaScript/Referência/Global_Objects/encodeURI	/en-US/docs/Web/JavaScript/Reference/Global_Objects/encodeURI
/pt-PT/docs/JavaScript/Referência/Global_Objects/encodeURIComponent	/en-US/docs/Web/JavaScript/Reference/Global_Objects/encodeURIComponent
/pt-PT/docs/JavaScript/Referência/Global_Objects/eval	/en-US/docs/Web/JavaScript/Reference/Global_Objects/eval
/pt-PT/docs/JavaScript/Referência/Global_Objects/isFinite	/en-US/docs/Web/JavaScript/Reference/Global_Objects/isFinite
/pt-PT/docs/JavaScript/Referência/Global_Objects/isNaN	/en-US/docs/Web/JavaScript/Reference/Global_Objects/isNaN
/pt-PT/docs/JavaScript/Referência/Global_Objects/parseFloat	/en-US/docs/Web/JavaScript/Reference/Global_Objects/parseFloat
/pt-PT/docs/JavaScript/Referência/Global_Objects/parseInt	/en-US/docs/Web/JavaScript/Reference/Global_Objects/parseInt
/pt-PT/docs/JavaScript/Referência/Global_Objects/undefined	/en-US/docs/Web/JavaScript/Reference/Global_Objects/undefined
/pt-PT/docs/JavaScript/Referência/Operators	/en-US/docs/Web/JavaScript/Reference/Operators
/pt-PT/docs/JavaScript/Referência/Operators/Arithmetic_Operators	/en-US/docs/Web/JavaScript/Reference/Operators
/pt-PT/docs/JavaScript/Referência/Operators/Assignment_Operators	/en-US/docs/Web/JavaScript/Reference/Operators#Assignment_operators
/pt-PT/docs/JavaScript/Referência/Operators/Bitwise_Operators	/en-US/docs/Web/JavaScript/Reference/Operators
/pt-PT/docs/JavaScript/Referência/Operators/Comparison_Operators	/en-US/docs/Web/JavaScript/Reference/Operators
/pt-PT/docs/JavaScript/Referência/Operators/Logical_Operators	/en-US/docs/Web/JavaScript/Reference/Operators
/pt-PT/docs/JavaScript/Referência/Operators/Member_Operators	/en-US/docs/Web/JavaScript/Reference/Operators/Property_Accessors
/pt-PT/docs/JavaScript/Referência/Operators/Operator_Precedence	/en-US/docs/Web/JavaScript/Reference/Operators/Operator_Precedence
/pt-PT/docs/JavaScript/Referência/Operators/Special/Comma_Operator	/en-US/docs/Web/JavaScript/Reference/Operators/Comma_Operator
/pt-PT/docs/JavaScript/Referência/Operators/Special/Conditional_Operator	/en-US/docs/Web/JavaScript/Reference/Operators/Conditional_Operator
/pt-PT/docs/JavaScript/Referência/Operators/Special/delete	/en-US/docs/Web/JavaScript/Reference/Operators/delete
/pt-PT/docs/JavaScript/Referência/Operators/Special/function	/en-US/docs/Web/JavaScript/Reference/Operators/function
/pt-PT/docs/JavaScript/Referência/Operators/Special/get	/en-US/docs/Web/JavaScript/Reference/Functions/get
/pt-PT/docs/JavaScript/Referência/Operators/Special/in	/en-US/docs/Web/JavaScript/Reference/Operators/in
/pt-PT/docs/JavaScript/Referência/Operators/Special/instanceof	/en-US/docs/Web/JavaScript/Reference/Operators/instanceof
/pt-PT/docs/JavaScript/Referência/Operators/Special/new	/en-US/docs/Web/JavaScript/Reference/Operators/new
/pt-PT/docs/JavaScript/Referência/Operators/Special/set	/en-US/docs/Web/JavaScript/Reference/Functions/set
/pt-PT/docs/JavaScript/Referência/Operators/Special/this	/en-US/docs/Web/JavaScript/Reference/Operators/this
/pt-PT/docs/JavaScript/Referência/Operators/Special/typeof	/en-US/docs/Web/JavaScript/Reference/Operators/typeof
/pt-PT/docs/JavaScript/Referência/Operators/Special/void	/en-US/docs/Web/JavaScript/Reference/Operators/void
/pt-PT/docs/JavaScript/Referência/Reserved_Words	/en-US/docs/Web/JavaScript/Reference/Lexical_grammar#Keywords
/pt-PT/docs/JavaScript/Referência/Statements	/en-US/docs/Web/JavaScript/Reference/Statements
/pt-PT/docs/JavaScript/Referência/Statements/block	/en-US/docs/Web/JavaScript/Reference/Statements/block
/pt-PT/docs/JavaScript/Referência/Statements/break	/en-US/docs/Web/JavaScript/Reference/Statements/break
/pt-PT/docs/JavaScript/Referência/Statements/const	/en-US/docs/Web/JavaScript/Reference/Statements/const
/pt-PT/docs/JavaScript/Referência/Statements/continue	/en-US/docs/Web/JavaScript/Reference/Statements/continue
/pt-PT/docs/JavaScript/Referência/Statements/debugger	/en-US/docs/Web/JavaScript/Reference/Statements/debugger
/pt-PT/docs/JavaScript/Referência/Statements/do...while	/en-US/docs/Web/JavaScript/Reference/Statements/do...while
/pt-PT/docs/JavaScript/Referência/Statements/export	/en-US/docs/Web/JavaScript/Reference/Statements/export
/pt-PT/docs/JavaScript/Referência/Statements/for	/en-US/docs/Web/JavaScript/Reference/Statements/for
/pt-PT/docs/JavaScript/Referência/Statements/for...in	/en-US/docs/Web/JavaScript/Reference/Statements/for...in
/pt-PT/docs/JavaScript/Referência/Statements/function	/en-US/docs/Web/JavaScript/Reference/Statements/function
/pt-PT/docs/JavaScript/Referência/Statements/if...else	/en-US/docs/Web/JavaScript/Reference/Statements/if...else
/pt-PT/docs/JavaScript/Referência/Statements/import	/en-US/docs/Web/JavaScript/Reference/Statements/import
/pt-PT/docs/JavaScript/Referência/Statements/label	/en-US/docs/Web/JavaScript/Reference/Statements/label
/pt-PT/docs/JavaScript/Referência/Statements/let	/en-US/docs/Web/JavaScript/Reference/Statements/let
/pt-PT/docs/JavaScript/Referência/Statements/return	/en-US/docs/Web/JavaScript/Reference/Statements/return
/pt-PT/docs/JavaScript/Referência/Statements/switch	/en-US/docs/Web/JavaScript/Reference/Statements/switch
/pt-PT/docs/JavaScript/Referência/Statements/throw	/en-US/docs/Web/JavaScript/Reference/Statements/throw
/pt-PT/docs/JavaScript/Referência/Statements/try...catch	/en-US/docs/Web/JavaScript/Reference/Statements/try...catch
/pt-PT/docs/JavaScript/Referência/Statements/var	/en-US/docs/Web/JavaScript/Reference/Statements/var
/pt-PT/docs/JavaScript/Referência/Statements/while	/en-US/docs/Web/JavaScript/Reference/Statements/while
/pt-PT/docs/JavaScript/Referência/Statements/with	/en-US/docs/Web/JavaScript/Reference/Statements/with
/pt-PT/docs/JavaScript/Referência/Symbols	/en-US/docs/Web/JavaScript/Reference/Global_Objects/Symbol
/pt-PT/docs/JavaScript:O_que_é_o_JavaScript	/pt-pt/docs/orphaned/Web/JavaScript/O_que_é_o_JavaScript
/pt-PT/docs/Learn/CSS/Estilo_de_caixas	/en-US/docs/Learn/CSS/Building_blocks
/pt-PT/docs/Learn/CSS/Introduction_to_CSS	/en-US/docs/Learn/CSS/First_steps
/pt-PT/docs/Learn/CSS/Introduction_to_CSS/Seletores	/en-US/docs/Learn/CSS/Building_blocks/Selectors
/pt-PT/docs/Learn/HTML/Introducao_ao_HTML	/pt-pt/docs/Learn/HTML/Introduction_to_HTML
/pt-PT/docs/MDN/Contribute/Editor	/pt-pt/docs/orphaned/MDN/Editor
/pt-PT/docs/MDN/Contribute/Editor/Basicos	/pt-pt/docs/orphaned/MDN/Editor/Basics
/pt-PT/docs/MDN/Contribute/Structures	/pt-PT/docs/MDN/Structures
/pt-PT/docs/MDN/Contribute/Structures/API_references	/pt-pt/docs/orphaned/MDN/Structures/API_references
/pt-PT/docs/MDN/Contribute/Structures/API_references/Barras_laterais_de_referencia_da_API	/pt-pt/docs/MDN/Contribute/Howto/Write_an_API_reference/Sidebars
/pt-PT/docs/MDN/Contribute/Structures/API_references/O_que_e_que_uma_referencia_de_API_precisa	/pt-pt/docs/orphaned/MDN/Structures/API_references/What_does_an_API_reference_need
/pt-PT/docs/MDN/Contribute/Structures/Exemplos_live	/pt-pt/docs/MDN/Structures/Live_samples
/pt-PT/docs/MDN/Contribute/Structures/Macros	/pt-PT/docs/MDN/Structures/Macros
/pt-PT/docs/MDN/Contribute/Tools	/pt-PT/docs/MDN/Tools
/pt-PT/docs/MDN/Contribute/Tools/Edição_de_modelo	/pt-pt/docs/orphaned/MDN/Tools/Template_editing
/pt-PT/docs/MDN/Contribute/Tools/KumaScript	/pt-PT/docs/MDN/Tools/KumaScript
/pt-PT/docs/MDN/Contribute/Tools/Vigiar_pagina	/pt-pt/docs/orphaned/MDN/Tools/Page_watching
/pt-PT/docs/MDN/Contribute/linhas_diretrizes	/pt-PT/docs/MDN/Guidelines
/pt-PT/docs/MDN/Contribute/linhas_diretrizes/Convencoes_definicoes	/pt-pt/docs/MDN/Guidelines/Conventions_definitions
/pt-PT/docs/MDN/Contribute/linhas_diretrizes/Guia_de_estilo_de_escrita	/pt-pt/docs/MDN/Guidelines/Writing_style_guide
/pt-PT/docs/MDN/Contribute/linhas_diretrizes/Isto_pertence_a_MDN	/pt-pt/docs/MDN/Guidelines/Does_this_belong_on_MDN
/pt-PT/docs/MDN/Contribute/resolucao_de_problemas	/pt-pt/docs/orphaned/MDN/Troubleshooting
/pt-PT/docs/MDN/Editor	/pt-pt/docs/orphaned/MDN/Editor
/pt-PT/docs/MDN/Editor/Basicos	/pt-pt/docs/orphaned/MDN/Editor/Basics
/pt-PT/docs/MDN/Guidelines/Convencoes_definicoes	/pt-pt/docs/MDN/Guidelines/Conventions_definitions
/pt-PT/docs/MDN/Guidelines/Guia_de_estilo_de_escrita	/pt-pt/docs/MDN/Guidelines/Writing_style_guide
/pt-PT/docs/MDN/Guidelines/Isto_pertence_a_MDN	/pt-pt/docs/MDN/Guidelines/Does_this_belong_on_MDN
/pt-PT/docs/MDN/Intrudução	/pt-PT/docs/MDN/Contribute/Getting_started
/pt-PT/docs/MDN/Opiniao	/pt-PT/docs/MDN/Contribute/Feedback
/pt-PT/docs/MDN/Structures/API_references	/pt-pt/docs/orphaned/MDN/Structures/API_references
/pt-PT/docs/MDN/Structures/API_references/Barras_laterais_de_referencia_da_API	/pt-pt/docs/MDN/Contribute/Howto/Write_an_API_reference/Sidebars
/pt-PT/docs/MDN/Structures/API_references/O_que_e_que_uma_referencia_de_API_precisa	/pt-pt/docs/orphaned/MDN/Structures/API_references/What_does_an_API_reference_need
/pt-PT/docs/MDN/Structures/Exemplos_live	/pt-pt/docs/MDN/Structures/Live_samples
/pt-PT/docs/MDN/Tools/Edição_de_modelo	/pt-pt/docs/orphaned/MDN/Tools/Template_editing
/pt-PT/docs/MDN/Tools/Vigiar_pagina	/pt-pt/docs/orphaned/MDN/Tools/Page_watching
/pt-PT/docs/MDN/Troubleshooting	/pt-pt/docs/orphaned/MDN/Troubleshooting
/pt-PT/docs/Manipuladores_de_protocolo_web	/pt-pt/docs/orphaned/Manipuladores_de_protocolo_web
/pt-PT/docs/Mozilla/Add-ons/WebExtensions/manifest.json/applications	/pt-PT/docs/Mozilla/Add-ons/WebExtensions/manifest.json/browser_specific_settings
/pt-PT/docs/Novidades_no_Javascript_1.8	/pt-PT/docs/Web/JavaScript/Novidades_no_JavaScript/Novidades_no_Javascript_1.8
/pt-PT/docs/Página_principal	/pt-PT/docs/Web
/pt-PT/docs/Referência_CSS	/pt-pt/docs/Web/CSS/Reference
/pt-PT/docs/Referência_do_DOM_Gecko/Prefácio	/pt-pt/docs/orphaned/Referência_do_DOM_Gecko/Prefácio
/pt-PT/docs/Referência_do_DOM_Gecko:Prefácio	/pt-pt/docs/orphaned/Referência_do_DOM_Gecko/Prefácio
/pt-PT/docs/SVG	/pt-PT/docs/Web/SVG
/pt-PT/docs/SVG/Tutorial	/pt-PT/docs/Web/SVG/Tutorial
/pt-PT/docs/Transformar_XML_com_XSLT/Para_leitura_adicional	/pt-pt/docs/orphaned/Transformar_XML_com_XSLT/Para_leitura_adicional
/pt-PT/docs/Transformar_XML_com_XSLT:Para_leitura_adicional	/pt-pt/docs/orphaned/Transformar_XML_com_XSLT/Para_leitura_adicional
/pt-PT/docs/Tutorial_XUL/Adicionando_botões	/pt-pt/docs/orphaned/Tutorial_XUL/Adicionando_botões
/pt-PT/docs/Tutorial_XUL/Criando_uma_janela	/pt-pt/docs/orphaned/Tutorial_XUL/Criando_uma_janela
/pt-PT/docs/Tutorial_XUL/Introdução	/pt-pt/docs/orphaned/Tutorial_XUL/Introdução
/pt-PT/docs/Tutorial_XUL:Adicionando_botões	/pt-pt/docs/orphaned/Tutorial_XUL/Adicionando_botões
/pt-PT/docs/Tutorial_XUL:Criando_uma_janela	/pt-pt/docs/orphaned/Tutorial_XUL/Criando_uma_janela
/pt-PT/docs/Tutorial_XUL:Introdução	/pt-pt/docs/orphaned/Tutorial_XUL/Introdução
/pt-PT/docs/Tutorial_do_Canvas/Utilização_básica	/pt-pt/docs/orphaned/Tutorial_do_Canvas/Utilização_básica
/pt-PT/docs/Tutorial_do_Canvas:_Utilização_básica	/pt-pt/docs/orphaned/Tutorial_do_Canvas/Utilização_básica
/pt-PT/docs/Usando_o_Núcleo_DOM_Nível_1_do_W3C	/pt-pt/docs/Web/API/Document_object_model/Using_the_W3C_DOM_Level_1_Core
/pt-PT/docs/Using_the_W3C_DOM_Level_1_Core	/pt-pt/docs/Web/API/Document_object_model/Using_the_W3C_DOM_Level_1_Core
/pt-PT/docs/Utilização_CXX_no_código_da_Mozilla	/pt-PT/docs/Mozilla/Utilização_CXX_no_código_da_Mozilla
/pt-PT/docs/Web/API/NavigatorOnLine/Eventos_online_e_offline	/pt-pt/docs/Web/API/NavigatorOnLine/Online_and_offline_events
/pt-PT/docs/Web/Acessibilidade	/pt-pt/docs/Web/Accessibility
/pt-PT/docs/Web/Apps/Progressiva	/pt-PT/docs/Web/Progressive_web_apps
/pt-PT/docs/Web/Apps/Progressiva/Identificavel	/pt-pt/docs/conflicting/Web/Progressive_web_apps
/pt-PT/docs/Web/Apps/Progressiva/Responsivo	/pt-pt/docs/conflicting/Web/Progressive_web_apps/Responsive/responsive_design_building_blocks
/pt-PT/docs/Web/Apps/Progressive/Seguro	/pt-pt/docs/conflicting/Web/Progressive_web_apps_c5ce9d8c3500409dbf6f879e4fe3cb8a
/pt-PT/docs/Web/CSS/:after	/pt-pt/docs/Web/CSS/::after
/pt-PT/docs/Web/CSS/:before	/pt-pt/docs/Web/CSS/::before
/pt-PT/docs/Web/CSS/CSS_Background_and_Borders/Múltiplos_planos_de_fundo	/pt-pt/docs/Web/CSS/CSS_Backgrounds_and_Borders/Using_multiple_backgrounds
/pt-PT/docs/Web/CSS/CSS_Colors	/en-US/docs/Web/CSS/CSS_Color
/pt-PT/docs/Web/CSS/Como_começar	/pt-pt/docs/Learn/CSS/First_steps
/pt-PT/docs/Web/CSS/Como_começar/CSS_legível	/pt-pt/docs/orphaned/Learn/CSS/Introduction_to_CSS/Syntax
/pt-PT/docs/Web/CSS/Como_começar/Caixas	/pt-pt/docs/Learn/CSS/Building_blocks
/pt-PT/docs/Web/CSS/Como_começar/Cascata_e_herança	/pt-pt/docs/Learn/CSS/Building_blocks/Cascade_and_inheritance
/pt-PT/docs/Web/CSS/Como_começar/Como_o_CSS_trabalha	/pt-pt/docs/Learn/CSS/First_steps/How_CSS_works
/pt-PT/docs/Web/CSS/Como_começar/Conteúdo	/pt-pt/docs/Learn/CSS/Howto/Generated_content
/pt-PT/docs/Web/CSS/Como_começar/Cor	/pt-pt/docs/orphaned/Learn/CSS/Introduction_to_CSS/Values_and_units
/pt-PT/docs/Web/CSS/Como_começar/Disposição	/pt-pt/docs/Learn/CSS/CSS_layout
/pt-PT/docs/Web/CSS/Como_começar/Estilos_de_texto	/pt-pt/docs/Learn/CSS/Styling_text/Fundamentals
/pt-PT/docs/Web/CSS/Como_começar/Gráficos_SVG	/pt-pt/docs/Web/SVG/Tutorial/SVG_and_CSS
/pt-PT/docs/Web/CSS/Como_começar/JavaScript	/pt-pt/docs/Learn/JavaScript/Client-side_web_APIs/Manipulating_documents
/pt-PT/docs/Web/CSS/Como_começar/Listas	/pt-pt/docs/Learn/CSS/Styling_text/Styling_lists
/pt-PT/docs/Web/CSS/Como_começar/Mídia	/pt-pt/docs/Web/Progressive_web_apps/Responsive/Media_types
/pt-PT/docs/Web/CSS/Como_começar/O_que_é_CSS	/pt-pt/docs/conflicting/Learn/CSS/First_steps/How_CSS_works
/pt-PT/docs/Web/CSS/Como_começar/O_que_é_CSS?	/pt-pt/docs/orphaned/Web/CSS/Como_começar/O_que_é_CSS?
/pt-PT/docs/Web/CSS/Como_começar/Porque_usar_CSS	/pt-pt/docs/conflicting/Learn/CSS/First_steps/How_CSS_works_0767812f50daab83155d62da97c6e460
/pt-PT/docs/Web/CSS/Como_começar/Seletores	/pt-pt/docs/Learn/CSS/Building_blocks/Selectors
/pt-PT/docs/Web/CSS/Como_começar/Tabelas	/pt-pt/docs/Learn/CSS/Building_blocks/Styling_tables
/pt-PT/docs/Web/CSS/Consulta_de_mídia	/pt-pt/docs/Web/CSS/Media_Queries/Using_media_queries
/pt-PT/docs/Web/CSS/Folhas_de_estilo_alternativas	/pt-pt/docs/Web/CSS/Alternative_style_sheets
/pt-PT/docs/Web/CSS/Múltiplos_fundos	/pt-pt/docs/Web/CSS/CSS_Backgrounds_and_Borders/Using_multiple_backgrounds
/pt-PT/docs/Web/CSS/Múltiplos_planos_de_fundo	/pt-pt/docs/Web/CSS/CSS_Backgrounds_and_Borders/Using_multiple_backgrounds
/pt-PT/docs/Web/CSS/Referência_CSS	/pt-pt/docs/Web/CSS/Reference
/pt-PT/docs/Web/CSS/Usando_transformações_CSS	/pt-pt/docs/Web/CSS/CSS_Transforms/Using_CSS_transforms
/pt-PT/docs/Web/Eventos/visibilitychange	/pt-PT/docs/Web/API/Document/visibilitychange_event
/pt-PT/docs/Web/Guide/AJAX/Como_começar	/pt-pt/docs/Web/Guide/AJAX/Getting_Started
/pt-PT/docs/Web/Guide/CSS	/pt-PT/docs/Learn/CSS
/pt-PT/docs/Web/Guide/HTML	/pt-PT/docs/Learn/HTML
/pt-PT/docs/Web/Guide/HTML/Introduction	/pt-pt/docs/Learn/HTML/Introduction_to_HTML
/pt-PT/docs/Web/HTML/Aplicar_cor__elementos_HTML_utilizando_CSS	/pt-pt/docs/Web/HTML/Applying_color
/pt-PT/docs/Web/HTML/Aplicar_cor_elementos_HTML_utilizando_CSS	/pt-pt/docs/Web/HTML/Applying_color
/pt-PT/docs/Web/HTML/Atributos	/pt-pt/docs/Web/HTML/Attributes
/pt-PT/docs/Web/HTML/Atributos_globais	/pt-pt/docs/Web/HTML/Global_attributes
/pt-PT/docs/Web/HTML/Elemento	/pt-pt/docs/Web/HTML/Element
/pt-PT/docs/Web/HTML/Elemento/Audio	/pt-pt/docs/Web/HTML/Element/audio
/pt-PT/docs/Web/HTML/Elemento/Video	/pt-pt/docs/Web/HTML/Element/video
/pt-PT/docs/Web/HTML/Elemento/figcaption	/pt-pt/docs/Web/HTML/Element/figcaption
/pt-PT/docs/Web/HTML/Elemento/head	/pt-pt/docs/Web/HTML/Element/head
/pt-PT/docs/Web/HTML/Elemento/nav	/pt-pt/docs/Web/HTML/Element/nav
/pt-PT/docs/Web/HTML/Elemento/progress	/pt-pt/docs/Web/HTML/Element/progress
/pt-PT/docs/Web/HTML/HTML5	/pt-pt/docs/Web/Guide/HTML/HTML5
/pt-PT/docs/Web/HTML/HTML5/Forms_no_HTML5	/pt-pt/docs/orphaned/Learn/HTML/Forms/HTML5_updates
/pt-PT/docs/Web/HTML/HTML5/Introdução_ao_HTML5	/pt-pt/docs/Web/Guide/HTML/HTML5/Introduction_to_HTML5
/pt-PT/docs/Web/HTML/HTML5/Parser_HTML5	/pt-pt/docs/Web/Guide/HTML/HTML5/HTML5_Parser
/pt-PT/docs/Web/HTML/Referencia	/pt-pt/docs/Web/HTML/Reference
/pt-PT/docs/Web/HTML/Tipos_de_hiperligacao	/pt-pt/docs/Web/HTML/Link_types
/pt-PT/docs/Web/HTML_Linguagem_de_marcacao_de_hipertexto	/pt-PT/docs/Web/HTML
/pt-PT/docs/Web/JavaScript/Guia	/pt-pt/docs/Web/JavaScript/Guide
/pt-PT/docs/Web/JavaScript/Guia/Expressoes_e_Operadores	/pt-pt/docs/orphaned/Web/JavaScript/Guia/Expressoes_e_Operadores
/pt-PT/docs/Web/JavaScript/Guia/Introdução_ao_JavaScript	/pt-pt/docs/orphaned/Web/JavaScript/Guia/Introdução_ao_JavaScript
/pt-PT/docs/Web/JavaScript/Guia/Sobre	/pt-pt/docs/orphaned/Web/JavaScript/Guia/Sobre
/pt-PT/docs/Web/JavaScript/Guia/Valores,_Variáveis_e_Literais	/pt-pt/docs/orphaned/Web/JavaScript/Guia/Valores,_Variáveis_e_Literais
/pt-PT/docs/Web/JavaScript/New_in_JavaScript	/pt-PT/docs/Web/JavaScript/Novidades_no_JavaScript
/pt-PT/docs/Web/JavaScript/O_que_é_o_JavaScript	/pt-pt/docs/orphaned/Web/JavaScript/O_que_é_o_JavaScript
/pt-PT/docs/Web/Progressive_web_apps/Identificavel	/pt-pt/docs/conflicting/Web/Progressive_web_apps
/pt-PT/docs/Web/Progressive_web_apps/Responsivo	/pt-pt/docs/conflicting/Web/Progressive_web_apps/Responsive/responsive_design_building_blocks
/pt-PT/docs/Web/Progressive_web_apps/Seguro	/pt-pt/docs/conflicting/Web/Progressive_web_apps_c5ce9d8c3500409dbf6f879e4fe3cb8a
/pt-PT/docs/Web/XML/Introducao_a_XML	/pt-pt/docs/Web/XML/XML_introduction
/pt-PT/docs/Web/XSLT/Comunidade	/pt-pt/docs/orphaned/Web/XSLT/Comunidade
/pt-PT/docs/Web/XSLT/Elementos	/pt-pt/docs/orphaned/Web/XSLT/Elementos
/pt-PT/docs/XForms/Controles_Customizados	/pt-pt/docs/orphaned/XForms/Controles_Customizados
/pt-PT/docs/XForms:Controles_Customizados	/pt-pt/docs/orphaned/XForms/Controles_Customizados
/pt-PT/docs/XPath/Eixos	/pt-pt/docs/orphaned/XPath/Eixos
/pt-PT/docs/XPath/Funções	/pt-pt/docs/orphaned/XPath/Funções
/pt-PT/docs/XPath:Eixos	/pt-pt/docs/orphaned/XPath/Eixos
/pt-PT/docs/XPath:Funções	/pt-pt/docs/orphaned/XPath/Funções
/pt-PT/docs/XSLT	/pt-PT/docs/Web/XSLT
/pt-PT/docs/XSLT/Comunidade	/pt-pt/docs/orphaned/Web/XSLT/Comunidade
/pt-PT/docs/XSLT/Elementos	/pt-pt/docs/orphaned/Web/XSLT/Elementos
/pt-PT/docs/XSLT:Comunidade	/pt-pt/docs/orphaned/Web/XSLT/Comunidade
/pt-PT/docs/XSLT:Elementos	/pt-pt/docs/orphaned/Web/XSLT/Elementos
/pt-PT/docs/en	/en-US/
/pt-PT/docs/manipuladores_de_protocolos_baseados_na_web	/pt-pt/docs/orphaned/Manipuladores_de_protocolo_web
/pt-pt/docs/Acentuação_para_conteúdos_carregados_por_AJAX	/pt-pt/docs/orphaned/Acentuação_para_conteúdos_carregados_por_AJAX
/pt-pt/docs/Atualizando_extensões_para_o_Firefox_3	/pt-pt/docs/Mozilla/Firefox/Releases/3/Updating_extensions
/pt-pt/docs/Atualizando_extensões_para_o_Firefox_3.5	/pt-pt/docs/Mozilla/Firefox/Releases/3.5/Updating_extensions
/pt-pt/docs/Componentes	/pt-pt/docs/orphaned/Componentes
/pt-pt/docs/Configurando_um_servidor_de_atualização	/pt-pt/docs/orphaned/Configurando_um_servidor_de_atualização
/pt-pt/docs/Construir_uma_Extensão	/pt-pt/docs/orphaned/Construir_uma_Extensão
/pt-pt/docs/Controles_XUL	/pt-pt/docs/orphaned/Controles_XUL
/pt-pt/docs/Criando_plugins_OpenSearch_para_o_Firefox	/pt-pt/docs/Web/OpenSearch
/pt-pt/docs/Criando_um_visual_para_o_Firefox	/pt-pt/docs/orphaned/Criando_um_visual_para_o_Firefox
/pt-pt/docs/Criar_uma_pele_para_o_Firefox	/pt-pt/docs/orphaned/Criar_uma_pele_para_o_Firefox
/pt-pt/docs/DHTML	/pt-pt/docs/Glossary/DHTML
/pt-pt/docs/DOM/Selection	/pt-pt/docs/Web/API/Selection
/pt-pt/docs/DOM/document.alinkColor	/pt-pt/docs/Web/API/Document/alinkColor
/pt-pt/docs/DOM/document.bgColor	/pt-pt/docs/Web/API/Document/bgColor
/pt-pt/docs/DOM/document.cookie	/pt-pt/docs/Web/API/Document/cookie
/pt-pt/docs/DOM_Inspector	/pt-pt/docs/orphaned/Tools/Add-ons/DOM_Inspector
/pt-pt/docs/DOM_Inspector/Introduction_to_DOM_Inspector	/pt-pt/docs/orphaned/Tools/Add-ons/DOM_Inspector/Introduction_to_DOM_Inspector
/pt-pt/docs/Desenhando_texto_usando_canvas	/pt-pt/docs/orphaned/Desenhando_texto_usando_canvas
/pt-pt/docs/FAQ_Extensões	/pt-pt/docs/orphaned/FAQ_Extensões
/pt-pt/docs/Firefox_1.5_para_Desenvolvedores	/pt-pt/docs/Mozilla/Firefox/Releases/1.5
/pt-pt/docs/Firefox_2_para_desenvolvedores	/pt-pt/docs/Mozilla/Firefox/Releases/2
/pt-pt/docs/Firefox_3.5_para_desenvolvedores	/pt-pt/docs/Mozilla/Firefox/Releases/3.5
/pt-pt/docs/Firefox_3.6_para_desenvolvedores	/pt-pt/docs/Mozilla/Firefox/Releases/3.6
/pt-pt/docs/Firefox_3_para_desenvolvedores	/pt-pt/docs/orphaned/Firefox_3_para_desenvolvedores
/pt-pt/docs/Firefox_4_para_desenvolvedores	/pt-pt/docs/Mozilla/Firefox/Releases/4
/pt-pt/docs/Firefox_5_para_desenvolvedores	/pt-pt/docs/Mozilla/Firefox/Releases/5
/pt-pt/docs/Firefox_6_para_desenvolvedores	/pt-pt/docs/Mozilla/Firefox/Releases/6
/pt-pt/docs/Glossário	/pt-pt/docs/Glossary
/pt-pt/docs/Glossário/404	/pt-pt/docs/Glossary/404
/pt-pt/docs/Glossário/502	/pt-pt/docs/Glossary/502
/pt-pt/docs/Glossário/AJAX	/pt-pt/docs/Glossary/AJAX
/pt-pt/docs/Glossário/API	/pt-pt/docs/conflicting/Glossary/API
/pt-pt/docs/Glossário/ARIA	/pt-pt/docs/Glossary/ARIA
/pt-pt/docs/Glossário/Acessibilidade	/pt-pt/docs/Glossary/Accessibility
/pt-pt/docs/Glossário/Argumento	/pt-pt/docs/Glossary/Argument
/pt-pt/docs/Glossário/Assinatura	/pt-pt/docs/Glossary/Signature
/pt-pt/docs/Glossário/BigInt	/pt-pt/docs/Glossary/BigInt
/pt-pt/docs/Glossário/CIA	/pt-pt/docs/Glossary/CIA
/pt-pt/docs/Glossário/CRLF	/pt-pt/docs/Glossary/CRLF
/pt-pt/docs/Glossário/CRUD	/pt-pt/docs/Glossary/CRUD
/pt-pt/docs/Glossário/Cabeçalho_de_entidade	/pt-pt/docs/Glossary/Entity_header
/pt-pt/docs/Glossário/Cache	/pt-pt/docs/Glossary/Cache
/pt-pt/docs/Glossário/Compilar	/pt-pt/docs/Glossary/Compile
/pt-pt/docs/Glossário/Compressao_GZip	/pt-pt/docs/Glossary/GZip_compression
/pt-pt/docs/Glossário/DOM	/pt-pt/docs/Glossary/DOM
/pt-pt/docs/Glossário/ECMA	/pt-pt/docs/Glossary/ECMA
/pt-pt/docs/Glossário/Eixo_principal	/pt-pt/docs/Glossary/Main_Axis
/pt-pt/docs/Glossário/Eixo_transversal	/pt-pt/docs/Glossary/Cross_Axis
/pt-pt/docs/Glossário/Elemento	/pt-pt/docs/Glossary/Element
/pt-pt/docs/Glossário/Etiqueta	/pt-pt/docs/Glossary/Tag
/pt-pt/docs/Glossário/Extensoes_da_Web	/pt-pt/docs/Glossary/WebExtensions
/pt-pt/docs/Glossário/Favicon	/pt-pt/docs/Glossary/Favicon
/pt-pt/docs/Glossário/Flexbox	/pt-pt/docs/Glossary/Flexbox
/pt-pt/docs/Glossário/GCS	/pt-pt/docs/Glossary/SCM
/pt-pt/docs/Glossário/Git	/pt-pt/docs/Glossary/Git
/pt-pt/docs/Glossário/HTML	/pt-pt/docs/Glossary/HTML
/pt-pt/docs/Glossário/Hipertexto	/pt-pt/docs/Glossary/Hypertext
/pt-pt/docs/Glossário/IANA	/pt-pt/docs/Glossary/IANA
/pt-pt/docs/Glossário/ISP	/pt-pt/docs/Glossary/ISP
/pt-pt/docs/Glossário/Idempotent	/pt-pt/docs/Glossary/Idempotent
/pt-pt/docs/Glossário/IndexedDB	/pt-pt/docs/Glossary/IndexedDB
/pt-pt/docs/Glossário/Lazy_load	/pt-pt/docs/Glossary/Lazy_load
/pt-pt/docs/Glossário/Metadados	/pt-pt/docs/Glossary/Metadata
/pt-pt/docs/Glossário/MitM	/pt-pt/docs/Glossary/MitM
/pt-pt/docs/Glossário/Modo_de_operação_de_cifra_de_bloco	/pt-pt/docs/Glossary/Block_cipher_mode_of_operation
/pt-pt/docs/Glossário/Motor	/pt-pt/docs/Glossary/Engine
/pt-pt/docs/Glossário/Navegador	/pt-pt/docs/Glossary/Browser
/pt-pt/docs/Glossário/Node.js	/pt-pt/docs/Glossary/Node.js
/pt-pt/docs/Glossário/OOP	/pt-pt/docs/Glossary/OOP
/pt-pt/docs/Glossário/OTA	/pt-pt/docs/Glossary/OTA
/pt-pt/docs/Glossário/Objeto	/pt-pt/docs/Glossary/Object
/pt-pt/docs/Glossário/Polyfill	/pt-pt/docs/Glossary/Polyfill
/pt-pt/docs/Glossário/Prototype-based_programming	/pt-pt/docs/Glossary/Prototype-based_programming
/pt-pt/docs/Glossário/Referencia_de_objeto	/pt-pt/docs/Glossary/Object_reference
/pt-pt/docs/Glossário/Servidor	/pt-pt/docs/Glossary/Server
/pt-pt/docs/Glossário/UTF-8	/pt-pt/docs/Glossary/UTF-8
/pt-pt/docs/Glossário/Valor	/pt-pt/docs/Glossary/Value
/pt-pt/docs/Glossário/Viewport	/pt-pt/docs/Glossary/Viewport
/pt-pt/docs/Glossário/Viewport_Visual	/pt-pt/docs/Glossary/Visual_Viewport
/pt-pt/docs/Glossário/WHATWG	/pt-pt/docs/Glossary/WHATWG
/pt-pt/docs/Glossário/WebRTC	/pt-pt/docs/Glossary/WebRTC
/pt-pt/docs/Glossário/WebVTT	/pt-pt/docs/Glossary/WebVTT
/pt-pt/docs/Glossário/World_Wide_Web	/pt-pt/docs/Glossary/World_Wide_Web
/pt-pt/docs/Glossário/Wrapper	/pt-pt/docs/Glossary/Wrapper
/pt-pt/docs/Glossário/XML	/pt-pt/docs/Glossary/XML
/pt-pt/docs/Glossário/booliano	/pt-pt/docs/Glossary/Boolean
/pt-pt/docs/JavaScript_Shells	/pt-pt/docs/Web/JavaScript/Shells
/pt-pt/docs/Java_em_Extensões_do_Firefox	/pt-pt/docs/orphaned/Java_em_Extensões_do_Firefox
/pt-pt/docs/Javascript_orientado_a_objetos	/pt-pt/docs/orphaned/Javascript_orientado_a_objetos
/pt-pt/docs/Jogos	/pt-pt/docs/Games
/pt-pt/docs/Jogos/Tutoriais	/pt-pt/docs/Games/Tutorials
/pt-pt/docs/Learn/Acessibilidade	/pt-pt/docs/Learn/Accessibility
/pt-pt/docs/Learn/CSS/Estilo_de_texto	/pt-pt/docs/Learn/CSS/Styling_text
/pt-pt/docs/Learn/CSS/Howto/FAQ_de_CSS	/pt-pt/docs/Learn/CSS/Howto/CSS_FAQ
/pt-pt/docs/Learn/Comecar_com_a_Web	/pt-pt/docs/Learn/Getting_started_with_the_web
/pt-pt/docs/Learn/Comecar_com_a_Web/A_web_e_os_padroes_da_web	/pt-pt/docs/Learn/Getting_started_with_the_web/The_web_and_web_standards
/pt-pt/docs/Learn/Comecar_com_a_Web/Apresentacao_do_meu_site	/pt-pt/docs/Learn/Getting_started_with_the_web/What_will_your_website_look_like
/pt-pt/docs/Learn/Comecar_com_a_Web/CSS_basico	/pt-pt/docs/Learn/Getting_started_with_the_web/CSS_basics
/pt-pt/docs/Learn/Comecar_com_a_Web/Como_funciona_a_Web	/pt-pt/docs/Learn/Getting_started_with_the_web/How_the_Web_works
/pt-pt/docs/Learn/Comecar_com_a_Web/Elementar_de_JavaScript	/pt-pt/docs/Learn/Getting_started_with_the_web/JavaScript_basics
/pt-pt/docs/Learn/Comecar_com_a_Web/HTML_basicos	/pt-pt/docs/Learn/Getting_started_with_the_web/HTML_basics
/pt-pt/docs/Learn/Comecar_com_a_Web/Installing_basic_software	/pt-pt/docs/Learn/Getting_started_with_the_web/Installing_basic_software
/pt-pt/docs/Learn/Comecar_com_a_Web/Lidar_com_ficheiros	/pt-pt/docs/Learn/Getting_started_with_the_web/Dealing_with_files
/pt-pt/docs/Learn/Comecar_com_a_Web/Publicar_o_seu_site_da_Web	/pt-pt/docs/Learn/Getting_started_with_the_web/Publishing_your_website
/pt-pt/docs/Learn/HTML/Como	/pt-pt/docs/Learn/HTML/Howto
/pt-pt/docs/Learn/HTML/Como/Adicionar_um_mapa_de_zona_clicavel_numa_imagem	/pt-pt/docs/Learn/HTML/Howto/Add_a_hit_map_on_top_of_an_image
/pt-pt/docs/Learn/HTML/Introducao_ao_HTML/Criar_hiperligacoes	/pt-pt/docs/Learn/HTML/Introduction_to_HTML/Creating_hyperlinks
/pt-pt/docs/Learn/HTML/Introducao_ao_HTML/Depurar_HTML	/pt-pt/docs/Learn/HTML/Introduction_to_HTML/Debugging_HTML
/pt-pt/docs/Learn/HTML/Introducao_ao_HTML/Estrutura_documento_website	/pt-pt/docs/Learn/HTML/Introduction_to_HTML/Document_and_website_structure
/pt-pt/docs/Learn/HTML/Introducao_ao_HTML/Estruturar_pagina_de_conteudo	/pt-pt/docs/Learn/HTML/Introduction_to_HTML/Structuring_a_page_of_content
/pt-pt/docs/Learn/HTML/Introducao_ao_HTML/Formatacao_avancada_texto	/pt-pt/docs/Learn/HTML/Introduction_to_HTML/Advanced_text_formatting
/pt-pt/docs/Learn/HTML/Introducao_ao_HTML/Iniciacao_HTML	/pt-pt/docs/Learn/HTML/Introduction_to_HTML/Getting_started
/pt-pt/docs/Learn/HTML/Introducao_ao_HTML/Os_metadados_de_head_em_HTML	/pt-pt/docs/Learn/HTML/Introduction_to_HTML/The_head_metadata_in_HTML
/pt-pt/docs/Learn/HTML/Introducao_ao_HTML/demarcar_uma_carta	/pt-pt/docs/Learn/HTML/Introduction_to_HTML/Marking_up_a_letter
/pt-pt/docs/Learn/HTML/Multimedia_and_embedding/Pagina_de_boas_vindas_da_Mozilla	/pt-pt/docs/Learn/HTML/Multimedia_and_embedding/Mozilla_splash_page
/pt-pt/docs/Learn/HTML/Multimedia_e_integracao	/pt-pt/docs/Learn/HTML/Multimedia_and_embedding
/pt-pt/docs/Learn/HTML/Multimedia_e_integracao/Conteudo_de_audio_e_vídeo	/pt-pt/docs/Learn/HTML/Multimedia_and_embedding/Video_and_audio_content
/pt-pt/docs/Learn/HTML/Tables/Avaliacao_Estruturar_os_dados_dos_planetas	/pt-pt/docs/Learn/HTML/Tables/Structuring_planet_data
/pt-pt/docs/Learn/HTML/Tables/Avancada	/pt-pt/docs/Learn/HTML/Tables/Advanced
/pt-pt/docs/Learn/HTML/Tables/Basicos	/pt-pt/docs/Learn/HTML/Tables/Basics
/pt-pt/docs/Learn/JavaScript/Primeiros_passos	/pt-pt/docs/Learn/JavaScript/First_steps
/pt-pt/docs/Learn/No-servidor	/pt-pt/docs/Learn/Server-side
/pt-pt/docs/Learn/No-servidor/Django	/pt-pt/docs/Learn/Server-side/Django
/pt-pt/docs/Learn/No-servidor/Express_Nodejs	/pt-pt/docs/Learn/Server-side/Express_Nodejs
/pt-pt/docs/Learn/No-servidor/Express_Nodejs/Configurar_um_meio_de_desenvolvimento_Node	/pt-pt/docs/Learn/Server-side/Express_Nodejs/development_environment
/pt-pt/docs/Learn/No-servidor/Express_Nodejs/Introduction	/pt-pt/docs/Learn/Server-side/Express_Nodejs/Introduction
/pt-pt/docs/Learn/No-servidor/Servidor_node_sem_framework	/pt-pt/docs/Learn/Server-side/Node_server_without_framework
/pt-pt/docs/Learn/Questoes_comuns	/pt-pt/docs/Learn/Common_questions
/pt-pt/docs/Learn/Questoes_comuns/Como_funciona_a_Internet	/pt-pt/docs/Learn/Common_questions/How_does_the_Internet_work
/pt-pt/docs/Learn/Questoes_comuns/Congiurar_um_servidor_de_testes_local	/pt-pt/docs/Learn/Common_questions/set_up_a_local_testing_server
/pt-pt/docs/Learn/Questoes_comuns/O_que_e_um_URL	/pt-pt/docs/Learn/Common_questions/What_is_a_URL
/pt-pt/docs/Learn/Questoes_comuns/O_que_e_um_nome_de_dominio	/pt-pt/docs/Learn/Common_questions/What_is_a_domain_name
/pt-pt/docs/Learn/Questoes_comuns/O_que_e_um_servidor_da_Web	/pt-pt/docs/Learn/Common_questions/What_is_a_web_server
/pt-pt/docs/Learn/Questoes_comuns/Qual_e_a_diferenca_entre_pagina_site_servidor_da_web_e_mecanismo_pesquisa	/pt-pt/docs/Learn/Common_questions/Pages_sites_servers_and_search_engines
/pt-pt/docs/Learn/Tools_and_testing/Teste_cruzado_de_navegador	/pt-pt/docs/Learn/Tools_and_testing/Cross_browser_testing
/pt-pt/docs/Learn/Tools_and_testing/Teste_cruzado_de_navegador/Acessibilidade	/pt-pt/docs/Learn/Tools_and_testing/Cross_browser_testing/Accessibility
/pt-pt/docs/Localizar_descrições_de_extensões	/pt-pt/docs/orphaned/Localizar_descrições_de_extensões
/pt-pt/docs/Localização	/pt-pt/docs/Glossary/Localization
/pt-pt/docs/MDN/Comunidade	/pt-pt/docs/orphaned/MDN/Community
/pt-pt/docs/MDN/Comunidade/Conversações	/pt-pt/docs/orphaned/MDN/Community/Conversations
/pt-pt/docs/MDN/Comunidade/Doc_sprints	/pt-pt/docs/orphaned/MDN/Community/Doc_sprints
/pt-pt/docs/MDN/Comunidade/O_que_está_a_acontecer	/pt-pt/docs/orphaned/MDN/Community/Whats_happening
/pt-pt/docs/MDN/Comunidade/Trabalhar_em_comunidade	/pt-pt/docs/orphaned/MDN/Community/Working_in_community
/pt-pt/docs/MDN/Contribute/Howto/Como_converter_exemplos_de_codigo_para_ficarem_live	/pt-pt/docs/MDN/Contribute/Howto/Convert_code_samples_to_be_live
/pt-pt/docs/MDN/Contribute/Howto/Como_definir_o_resumo_para_uma_pagina	/pt-pt/docs/orphaned/MDN/Contribute/Howto/Set_the_summary_for_a_page
/pt-pt/docs/MDN/Contribute/Howto/Como_efetuar_revisao_tecnica	/pt-pt/docs/orphaned/MDN/Contribute/Howto/Do_a_technical_review
/pt-pt/docs/MDN/Contribute/Howto/Como_escrever_um_artigo_para_ajudar_as_pessoas_a_aprenderem_sobre_a_Web	/pt-pt/docs/orphaned/MDN/Contribute/Howto/Write_an_article_to_help_learn_about_the_Web
/pt-pt/docs/MDN/Contribute/Howto/Como_escrever_uma_nova_entrada_no_Glossario	/pt-pt/docs/MDN/Contribute/Howto/Write_a_new_entry_in_the_Glossary
/pt-pt/docs/MDN/Contribute/Howto/Comunicar_um_problema	/pt-pt/docs/MDN/Contribute/Howto/Report_a_problem
/pt-pt/docs/MDN/Contribute/Howto/Criar_e_editar_paginas	/pt-pt/docs/MDN/Contribute/Howto/Create_and_edit_pages
/pt-pt/docs/MDN/Contribute/Howto/Criar_uma_conta_MDN	/pt-pt/docs/orphaned/MDN/Contribute/Howto/Create_an_MDN_account
/pt-pt/docs/MDN/Contribute/Howto/Etiqueta	/pt-pt/docs/MDN/Contribute/Howto/Tag
/pt-pt/docs/MDN/Contribute/Howto/Marcar_paginas_JavaScript	/pt-pt/docs/orphaned/MDN/Contribute/Howto/Tag_JavaScript_pages
/pt-pt/docs/MDN/Contribute/Howto/Participar_testes_beta	/pt-pt/docs/orphaned/MDN/Contribute/Howto/Be_a_beta_tester
/pt-pt/docs/MDN/Contribute/Howto/fazer_revisão_editorial	/pt-pt/docs/orphaned/MDN/Contribute/Howto/Do_an_editorial_review
/pt-pt/docs/MDN/Kuma	/pt-pt/docs/MDN/Yari
/pt-pt/docs/MDN/Sobre	/pt-pt/docs/MDN/About
/pt-pt/docs/MDN_at_ten	/pt-pt/docs/MDN/At_ten
/pt-pt/docs/MDN_at_ten/Contribuir_para_MDN	/pt-pt/docs/conflicting/MDN/Contribute
/pt-pt/docs/MDN_at_ten/Historia_da_MDN	/pt-pt/docs/MDN/At_ten/History_of_MDN
/pt-pt/docs/Melhorias_do_Gerenciador_de_Downloads_no_Firefox_3	/pt-pt/docs/orphaned/Melhorias_do_Gerenciador_de_Downloads_no_Firefox_3
/pt-pt/docs/Mozilla/Add-ons/WebExtensions/API/Armazenamento	/pt-pt/docs/Mozilla/Add-ons/WebExtensions/API/storage
/pt-pt/docs/Mozilla/Add-ons/WebExtensions/API/devtools.panels	/pt-pt/docs/Mozilla/Add-ons/WebExtensions/API/devtools/panels
/pt-pt/docs/Mozilla/Add-ons/WebExtensions/A_sua_primeira_extensao	/pt-pt/docs/Mozilla/Add-ons/WebExtensions/Your_first_WebExtension
/pt-pt/docs/Mozilla/Add-ons/WebExtensions/A_sua_segunda_extensao	/pt-pt/docs/Mozilla/Add-ons/WebExtensions/Your_second_WebExtension
/pt-pt/docs/Mozilla/Add-ons/WebExtensions/Anatomia_de_uma_extensao	/pt-pt/docs/Mozilla/Add-ons/WebExtensions/Anatomy_of_a_WebExtension
/pt-pt/docs/Mozilla/Add-ons/WebExtensions/As_melhores_praticas_de_experiencia_do_utilizador	/pt-pt/docs/orphaned/Mozilla/Add-ons/WebExtensions/User_experience_best_practices
/pt-pt/docs/Mozilla/Add-ons/WebExtensions/Conversao_de_uma_extensao_legada_do_firefox	/pt-pt/docs/orphaned/Mozilla/Add-ons/WebExtensions/Porting_a_legacy_Firefox_add-on
/pt-pt/docs/Mozilla/Add-ons/WebExtensions/E_a_seguir	/pt-pt/docs/Mozilla/Add-ons/WebExtensions/What_next_
/pt-pt/docs/Mozilla/Add-ons/WebExtensions/Exemplos_extensoes	/pt-pt/docs/Mozilla/Add-ons/WebExtensions/Examples
/pt-pt/docs/Mozilla/Add-ons/WebExtensions/ExtennsoesWeb_e_a_id_do_extra	/pt-pt/docs/orphaned/Mozilla/Add-ons/WebExtensions/WebExtensions_and_the_Add-on_ID
/pt-pt/docs/Mozilla/Add-ons/WebExtensions/Extensão_das_ferramentas_de_desenvolvimento	/pt-pt/docs/Mozilla/Add-ons/WebExtensions/Extending_the_developer_tools
/pt-pt/docs/Mozilla/Add-ons/WebExtensions/Instalacao_temporaria_no_Firefox	/pt-pt/docs/orphaned/Mozilla/Add-ons/WebExtensions/Temporary_Installation_in_Firefox
/pt-pt/docs/Mozilla/Add-ons/WebExtensions/Interceptar_Pedidos_HTTP	/pt-pt/docs/Mozilla/Add-ons/WebExtensions/Intercept_HTTP_requests
/pt-pt/docs/Mozilla/Add-ons/WebExtensions/O_que_sao_WebExtensions	/pt-pt/docs/Mozilla/Add-ons/WebExtensions/What_are_WebExtensions
/pt-pt/docs/Mozilla/Add-ons/WebExtensions/Primeiros_passos_com_web-ext	/pt-pt/docs/orphaned/Mozilla/Add-ons/WebExtensions/Getting_started_with_web-ext
/pt-pt/docs/Mozilla/Add-ons/WebExtensions/Publicar_a_sua_extensao	/pt-pt/docs/orphaned/Mozilla/Add-ons/WebExtensions/Package_your_extension_
/pt-pt/docs/Mozilla/Add-ons/WebExtensions/Scripts_Conteudo	/pt-pt/docs/Mozilla/Add-ons/WebExtensions/Content_scripts
/pt-pt/docs/Mozilla/Add-ons/WebExtensions/Suporte_navegador_APIs_JavaScript	/pt-pt/docs/Mozilla/Add-ons/WebExtensions/Browser_support_for_JavaScript_APIs
/pt-pt/docs/Mozilla/Add-ons/WebExtensions/Trasnsferir_extensao_Google_Chrome	/pt-pt/docs/orphaned/Mozilla/Add-ons/WebExtensions/Porting_a_Google_Chrome_extension
/pt-pt/docs/Mozilla/Add-ons/WebExtensions/dubla_padrões	/pt-pt/docs/Mozilla/Add-ons/WebExtensions/Match_patterns
/pt-pt/docs/Mozilla/Add-ons/WebExtensions/interface_do_utilizador	/pt-pt/docs/Mozilla/Add-ons/WebExtensions/user_interface
/pt-pt/docs/Mozilla/Add-ons/WebExtensions/interface_do_utilizador/Acoes_pagina	/pt-pt/docs/Mozilla/Add-ons/WebExtensions/user_interface/Page_actions
/pt-pt/docs/Mozilla/Add-ons/WebExtensions/interface_do_utilizador/Ação_navegador	/pt-pt/docs/Mozilla/Add-ons/WebExtensions/user_interface/Browser_action
/pt-pt/docs/Mozilla/Add-ons/WebExtensions/interface_do_utilizador/Barras_laterais	/pt-pt/docs/Mozilla/Add-ons/WebExtensions/user_interface/Sidebars
/pt-pt/docs/Mozilla/Add-ons/WebExtensions/interface_do_utilizador/Estilos_de_navegador	/pt-pt/docs/Mozilla/Add-ons/WebExtensions/user_interface/Browser_styles
/pt-pt/docs/Mozilla/Add-ons/WebExtensions/interface_do_utilizador/Itens_do_menu_de_contexto	/pt-pt/docs/Mozilla/Add-ons/WebExtensions/user_interface/Context_menu_items
/pt-pt/docs/Mozilla/Add-ons/WebExtensions/interface_do_utilizador/Notificacoes	/pt-pt/docs/Mozilla/Add-ons/WebExtensions/user_interface/Notifications
/pt-pt/docs/Mozilla/Add-ons/WebExtensions/interface_do_utilizador/Omnibox	/pt-pt/docs/Mozilla/Add-ons/WebExtensions/user_interface/Omnibox
/pt-pt/docs/Mozilla/Add-ons/WebExtensions/interface_do_utilizador/Options_pages	/pt-pt/docs/Mozilla/Add-ons/WebExtensions/user_interface/Options_pages
/pt-pt/docs/Mozilla/Add-ons/WebExtensions/interface_do_utilizador/Paginas_de_extensão	/pt-pt/docs/Mozilla/Add-ons/WebExtensions/user_interface/Extension_pages
/pt-pt/docs/Mozilla/Add-ons/WebExtensions/interface_do_utilizador/Popups	/pt-pt/docs/Mozilla/Add-ons/WebExtensions/user_interface/Popups
/pt-pt/docs/Mozilla/Add-ons/WebExtensions/interface_do_utilizador/devtools_panels	/pt-pt/docs/Mozilla/Add-ons/WebExtensions/user_interface/devtools_panels
/pt-pt/docs/Mozilla/Add-ons/WebExtensions/manifest.json/icones	/pt-pt/docs/Mozilla/Add-ons/WebExtensions/manifest.json/icons
/pt-pt/docs/Mudanças_no_Gecko_1.9_que_afetam_websites	/pt-pt/docs/Mozilla/Firefox/Releases/3/Site_compatibility
/pt-pt/docs/O_DOM_e_o_JavaScript	/pt-pt/docs/orphaned/O_DOM_e_o_JavaScript
/pt-pt/docs/Plugins/Ativacao_de_Flash:_comparacao_de_navegador	/pt-pt/docs/orphaned/Plugins/Flash_Activation:_Browser_Comparison
/pt-pt/docs/Plugins/Flash_para_HTML5	/pt-pt/docs/Plugins/Flash_to_HTML5
/pt-pt/docs/Referência_JSDBGAPI	/pt-pt/docs/orphaned/Referência_JSDBGAPI
/pt-pt/docs/Sobre_o_Document_Object_Model	/pt-pt/docs/orphaned/Sobre_o_Document_Object_Model
/pt-pt/docs/Tinderbox	/pt-pt/docs/orphaned/Tinderbox
/pt-pt/docs/Toolkit_API	/pt-pt/docs/orphaned/Toolkit_API
/pt-pt/docs/Tools/Add-ons	/pt-pt/docs/orphaned/Tools/Add-ons
/pt-pt/docs/Tools/Capturas_de_ecra	/pt-pt/docs/Tools/Taking_screenshots
/pt-pt/docs/Tools/Configurações	/pt-pt/docs/Tools/Settings
/pt-pt/docs/Tools/Consola_da_Web	/pt-pt/docs/Tools/Web_Console
/pt-pt/docs/Tools/Consola_da_Web/Abertura_Consola_Web	/pt-pt/docs/Tools/Web_Console/UI_Tour
/pt-pt/docs/Tools/Consola_da_Web/Ajuda	/pt-pt/docs/Tools/Web_Console/Helpers
/pt-pt/docs/Tools/Consola_da_Web/Atalhos_teclado	/pt-pt/docs/Tools/Web_Console/Keyboard_shortcuts
/pt-pt/docs/Tools/Consola_da_Web/Dividir_consola	/pt-pt/docs/Tools/Web_Console/Split_console
/pt-pt/docs/Tools/Consola_da_Web/Mensagens_consola	/pt-pt/docs/Tools/Web_Console/Console_messages
/pt-pt/docs/Tools/Consola_da_Web/O_interprete_da_linha_de_comandos	/pt-pt/docs/Tools/Web_Console/The_command_line_interpreter
/pt-pt/docs/Tools/Consola_da_Web/Rich_output	/pt-pt/docs/Tools/Web_Console/Rich_output
/pt-pt/docs/Tools/Debugger/Demonstracao_IU	/pt-pt/docs/Tools/Debugger/UI_Tour
/pt-pt/docs/Tools/Debugger/How_to/Abrir_o_depurador	/pt-pt/docs/Tools/Debugger/How_to/Open_the_debugger
/pt-pt/docs/Tools/Desempenho	/pt-pt/docs/Tools/Performance
/pt-pt/docs/Tools/Desempenho/Arvore_de_Chamada	/pt-pt/docs/Tools/Performance/Call_Tree
/pt-pt/docs/Tools/Desempenho/Cascata	/pt-pt/docs/Tools/Performance/Waterfall
/pt-pt/docs/Tools/Desempenho/Como_fazer	/pt-pt/docs/Tools/Performance/How_to
/pt-pt/docs/Tools/Desempenho/Frame_rate	/pt-pt/docs/Tools/Performance/Frame_rate
/pt-pt/docs/Tools/Editor_de_audio_da_Web	/pt-pt/docs/Tools/Web_Audio_Editor
/pt-pt/docs/Tools/Editor_de_estilo	/pt-pt/docs/Tools/Style_Editor
/pt-pt/docs/Tools/Inspetor_de_armazenamento	/pt-pt/docs/Tools/Storage_Inspector
/pt-pt/docs/Tools/Memoria	/pt-pt/docs/Tools/Memory
/pt-pt/docs/Tools/Modo_de_Desenho_Adaptavel	/pt-pt/docs/Tools/Responsive_Design_Mode
/pt-pt/docs/Tools/Page_Inspector/Guia_de_IU	/pt-pt/docs/Tools/Page_Inspector/UI_Tour
/pt-pt/docs/Tools/Page_Inspector/How_to/Abrir_o_inspetor	/pt-pt/docs/Tools/Page_Inspector/How_to/Open_the_Inspector
/pt-pt/docs/Tools/Page_Inspector/How_to/Examinar_e_editar_CSS	/pt-pt/docs/Tools/Page_Inspector/How_to/Examine_and_edit_CSS
/pt-pt/docs/Tools/Page_Inspector/How_to/Examinar_e_editar_o_modelo_de_caixa	/pt-pt/docs/Tools/Page_Inspector/How_to/Examine_and_edit_the_box_model
/pt-pt/docs/Tools/Page_Inspector/How_to/Inspecionar_e_selecionar_cores	/pt-pt/docs/Tools/Page_Inspector/How_to/Inspect_and_select_colors
/pt-pt/docs/Tools/Page_Inspector/How_to/Reposicao_de_elementos_na_pagina	/pt-pt/docs/Tools/Page_Inspector/How_to/Reposition_elements_in_the_page
/pt-pt/docs/Tools/Page_Inspector/How_to/Trabalhar_com_animacoes	/pt-pt/docs/Tools/Page_Inspector/How_to/Work_with_animations
/pt-pt/docs/Tools/Page_Inspector/How_to/Utilizar_a_API_do_Inspetor	/pt-pt/docs/Tools/Page_Inspector/How_to/Use_the_Inspector_API
/pt-pt/docs/Tools/Page_Inspector/How_to/Visualizar_tipos_de_letra	/pt-pt/docs/Tools/Page_Inspector/How_to/Edit_fonts
/pt-pt/docs/Tools/Page_Inspector/atalhos_de_teclado	/pt-pt/docs/Tools/Page_Inspector/Keyboard_shortcuts
/pt-pt/docs/Tools/Performance/Guia_da_IU	/pt-pt/docs/Tools/Performance/UI_Tour
/pt-pt/docs/Tools/Remote_Debugging/Depuracao_remota_Thunderbird	/pt-pt/docs/Tools/Remote_Debugging/Thunderbird
/pt-pt/docs/Tools/atalhos_de_teclado	/pt-pt/docs/Tools/Keyboard_shortcuts
/pt-pt/docs/Transformar_XML_com_XSLT	/pt-pt/docs/orphaned/Transformar_XML_com_XSLT
/pt-pt/docs/Tutorial_XUL	/pt-pt/docs/orphaned/Tutorial_XUL
/pt-pt/docs/Tutorial_do_Canvas	/pt-pt/docs/orphaned/Tutorial_do_Canvas
/pt-pt/docs/Tutorial_do_Canvas/Formas_de_desenho	/pt-pt/docs/orphaned/Tutorial_do_Canvas/Formas_de_desenho
/pt-pt/docs/Um_pequeno_exemplo_usando_AJAX	/pt-pt/docs/orphaned/Um_pequeno_exemplo_usando_AJAX
/pt-pt/docs/Usando_privilégios_expandidos_em_navegadores_Mozilla	/pt-pt/docs/orphaned/Usando_privilégios_expandidos_em_navegadores_Mozilla
/pt-pt/docs/Usando_áudio_e_vídeo_no_Firefox	/pt-pt/docs/orphaned/Usando_áudio_e_vídeo_no_Firefox
/pt-pt/docs/Utilizando_meta_tags	/pt-pt/docs/orphaned/Utilizando_meta_tags
/pt-pt/docs/Venkman	/pt-pt/docs/orphaned/Venkman
/pt-pt/docs/Web/API/API_Autenticacao_Web	/pt-pt/docs/Web/API/Web_Authentication_API
/pt-pt/docs/Web/API/API_Entradas_de_Diretoria_e_Ficheiro	/pt-pt/docs/Web/API/File_and_Directory_Entries_API
/pt-pt/docs/Web/API/API_WebRTC	/pt-pt/docs/Web/API/WebRTC_API
/pt-pt/docs/Web/API/API_WebRTC/Tirar_fotografias	/pt-pt/docs/Web/API/WebRTC_API/Taking_still_photos
/pt-pt/docs/Web/API/API_armazenamento	/pt-pt/docs/Web/API/Storage_API
/pt-pt/docs/Web/API/API_de_Armazenamento_da_Web	/pt-pt/docs/conflicting/Web/API/Web_Storage_API
/pt-pt/docs/Web/API/API_de_canvas	/pt-pt/docs/Web/API/Canvas_API
/pt-pt/docs/Web/API/API_de_canvas/Tutorial	/pt-pt/docs/Web/API/Canvas_API/Tutorial
/pt-pt/docs/Web/API/API_do_Estado_da_Bateria	/pt-pt/docs/Web/API/Battery_Status_API
/pt-pt/docs/Web/API/API_transmissoes_multimedia	/pt-pt/docs/Web/API/Media_Streams_API
/pt-pt/docs/Web/API/Document.dir	/pt-pt/docs/Web/API/Document/dir
/pt-pt/docs/Web/API/Eventos_de_Luz_Ambiente	/pt-pt/docs/Web/API/Ambient_Light_Events
/pt-pt/docs/Web/API/Geolocation/Utilizacao_da_geolocalizacao	/pt-pt/docs/Web/API/Geolocation_API
/pt-pt/docs/Web/API/Metadados	/pt-pt/docs/Web/API/Metadata
/pt-pt/docs/Web/API/Notifications_API/Utilizar_API_Notificações	/pt-pt/docs/Web/API/Notifications_API/Using_the_Notifications_API
/pt-pt/docs/Web/API/Sistema_de_ficheiros	/pt-pt/docs/Web/API/FileSystem
/pt-pt/docs/Web/API/WebGL_API/Constantes	/pt-pt/docs/Web/API/WebGL_API/Constants
/pt-pt/docs/Web/API/WebGL_API/Dados	/pt-pt/docs/Web/API/WebGL_API/Data
/pt-pt/docs/Web/API/WebGL_API/Tipos	/pt-pt/docs/Web/API/WebGL_API/Types
/pt-pt/docs/Web/API/WebGL_API/Utilizar_Extensões	/pt-pt/docs/Web/API/WebGL_API/Using_Extensions
/pt-pt/docs/Web/API/WebSockets_API/Escrever_aplicação_cliente_de_WebSocket	/pt-pt/docs/Web/API/WebSockets_API/Writing_WebSocket_client_applications
/pt-pt/docs/Web/API/WebSockets_API/Escrever_servidores_de_WebSocket	/pt-pt/docs/Web/API/WebSockets_API/Writing_WebSocket_servers
/pt-pt/docs/Web/API/WebSockets_API/Escrever_um_servidor_WebSocket_em_C	/pt-pt/docs/Web/API/WebSockets_API/Writing_WebSocket_server
/pt-pt/docs/Web/API/WebSockets_API/Escrever_um_servidor_WebSocket_em_Java	/pt-pt/docs/Web/API/WebSockets_API/Writing_a_WebSocket_server_in_Java
/pt-pt/docs/Web/API/Web_Audio_API/Utilizar_api_audio_web	/pt-pt/docs/Web/API/Web_Audio_API/Using_Web_Audio_API
/pt-pt/docs/Web/API/Web_Workers_API/Utilizacao_de_web_workers	/pt-pt/docs/Web/API/Web_Workers_API/Using_web_workers
/pt-pt/docs/Web/API/Window/barra_lateral	/pt-pt/docs/Web/API/Window/sidebar
/pt-pt/docs/Web/Accessibility/ARIA/ARIA_Techniques/Usando_o_role_status	/pt-pt/docs/Web/Accessibility/ARIA/ARIA_Techniques/Using_the_status_role
/pt-pt/docs/Web/Acessibilidade/ARIA	/pt-pt/docs/Web/Accessibility/ARIA
/pt-pt/docs/Web/CSS/CSS_Background_and_Borders	/pt-pt/docs/Web/CSS/CSS_Backgrounds_and_Borders
/pt-pt/docs/Web/CSS/CSS_Box_Model/Introducao_modelo_caixa_CSS	/pt-pt/docs/Web/CSS/CSS_Box_Model/Introduction_to_the_CSS_box_model
/pt-pt/docs/Web/CSS/CSS_Colors/Ferramenta_selecao_cor	/pt-pt/docs/Web/CSS/CSS_Colors/Color_picker_tool
/pt-pt/docs/Web/CSS/CSS_Flexible_Box_Layout/alinhamento_de_itens_num_recipiente_flex	/pt-pt/docs/Web/CSS/CSS_Flexible_Box_Layout/Aligning_Items_in_a_Flex_Container
/pt-pt/docs/Web/CSS/CSS_Flexible_Box_Layout/casos_de_utilizacao_tipicos_do_flexbox	/pt-pt/docs/Web/CSS/CSS_Flexible_Box_Layout/Typical_Use_Cases_of_Flexbox
/pt-pt/docs/Web/CSS/CSS_Flexible_Box_Layout/ordenacao_dos_itens_flex	/pt-pt/docs/Web/CSS/CSS_Flexible_Box_Layout/Ordering_Flex_Items
/pt-pt/docs/Web/CSS/CSS_Flexible_Box_Layout/relação_do_flexbox_com_outros_métodos_de_layout	/pt-pt/docs/Web/CSS/CSS_Flexible_Box_Layout/Relationship_of_Flexbox_to_Other_Layout_Methods
/pt-pt/docs/Web/CSS/CSS_Tipos	/pt-pt/docs/Web/CSS/CSS_Types
/pt-pt/docs/Web/CSS/Consultas_de_media	/pt-pt/docs/Web/CSS/Media_Queries
/pt-pt/docs/Web/CSS/Média_paginada	/pt-pt/docs/Web/CSS/Paged_Media
/pt-pt/docs/Web/CSS/Pseudoclasses	/pt-pt/docs/Web/CSS/Pseudo-classes
/pt-pt/docs/Web/CSS/Pseudoelementos	/pt-pt/docs/Web/CSS/Pseudo-elements
/pt-pt/docs/Web/CSS/grid-gap	/pt-pt/docs/Web/CSS/gap
/pt-pt/docs/Web/CSS/layout_de_grelha_css	/pt-pt/docs/Web/CSS/CSS_Grid_Layout
/pt-pt/docs/Web/Componentes_Web	/pt-pt/docs/Web/Web_Components
/pt-pt/docs/Web/Eventos	/pt-pt/docs/Web/Events
/pt-pt/docs/Web/Guide/AJAX/Comunidade	/pt-pt/docs/Web/Guide/AJAX/Community
/pt-pt/docs/Web/Guide/Eventos	/pt-pt/docs/Web/Guide/Events
/pt-pt/docs/Web/Guide/Gráficos	/pt-pt/docs/Web/Guide/Graphics
/pt-pt/docs/Web/Guide/HTML/Categorias_de_conteudo	/pt-pt/docs/Web/Guide/HTML/Content_categories
/pt-pt/docs/Web/Guide/HTML/Utilizar_estruturas_e_seccoes_de_HTML	/pt-pt/docs/Web/Guide/HTML/Using_HTML_sections_and_outlines
/pt-pt/docs/Web/HTML/Atributos/rel	/pt-pt/docs/Web/HTML/Attributes/rel
/pt-pt/docs/Web/HTML/CORS_settings_attributes	/pt-pt/docs/Web/HTML/Attributes/crossorigin
/pt-pt/docs/Web/HTML/Elemento/fieldset	/pt-pt/docs/Web/HTML/Element/fieldset
/pt-pt/docs/Web/HTML/Utilizar_a_cache_de_aplicacao	/pt-pt/docs/Web/HTML/Using_the_application_cache
/pt-pt/docs/Web/JavaScript/Estruturas_de_dados	/pt-pt/docs/Web/JavaScript/Data_structures
/pt-pt/docs/Web/JavaScript/Gestao_Memoria	/pt-pt/docs/Web/JavaScript/Memory_Management
/pt-pt/docs/Web/JavaScript/Guia/Detalhes_do_modelo_de_objeto	/pt-pt/docs/Web/JavaScript/Guide/Details_of_the_Object_Model
/pt-pt/docs/Web/JavaScript/Guia/Gramática_e_tipos	/pt-pt/docs/Web/JavaScript/Guide/Grammar_and_types
/pt-pt/docs/Web/JavaScript/Guia/Introdução	/pt-pt/docs/Web/JavaScript/Guide/Introduction
/pt-pt/docs/Web/JavaScript/Reference/Errors/declaração_função_sem_nome	/pt-pt/docs/Web/JavaScript/Reference/Errors/Unnamed_function_statement
/pt-pt/docs/Web/JavaScript/Reference/Extratos_e_declarações	/pt-pt/docs/Web/JavaScript/Reference/Statements
/pt-pt/docs/Web/JavaScript/Reference/Extratos_e_declarações/bloco	/pt-pt/docs/Web/JavaScript/Reference/Statements/block
/pt-pt/docs/Web/JavaScript/Reference/Extratos_e_declarações/for	/pt-pt/docs/Web/JavaScript/Reference/Statements/for
/pt-pt/docs/Web/JavaScript/Reference/Extratos_e_declarações/return	/pt-pt/docs/Web/JavaScript/Reference/Statements/return
/pt-pt/docs/Web/JavaScript/Reference/Extratos_e_declarações/throw	/pt-pt/docs/Web/JavaScript/Reference/Statements/throw
/pt-pt/docs/Web/JavaScript/Reference/Funcionalidades_obsoletas	/pt-pt/docs/Web/JavaScript/Reference/Deprecated_and_obsolete_features
/pt-pt/docs/Web/JavaScript/Reference/Funcoes	/pt-pt/docs/Web/JavaScript/Reference/Functions
/pt-pt/docs/Web/JavaScript/Reference/Funcoes/Funcoes_seta	/pt-pt/docs/Web/JavaScript/Reference/Functions/Arrow_functions
/pt-pt/docs/Web/JavaScript/Reference/Funcoes/arguments	/pt-pt/docs/Web/JavaScript/Reference/Functions/arguments
/pt-pt/docs/Web/JavaScript/Reference/Funcoes/parametros_rest	/pt-pt/docs/Web/JavaScript/Reference/Functions/rest_parameters
/pt-pt/docs/Web/JavaScript/Reference/Global_Objects/AsyncFunction/prototype	/pt-pt/docs/orphaned/Web/JavaScript/Reference/Global_Objects/AsyncFunction/prototype
/pt-pt/docs/Web/JavaScript/Reference/Global_Objects/Number/prototype	/pt-pt/docs/conflicting/Web/JavaScript/Reference/Global_Objects/Number
/pt-pt/docs/Web/JavaScript/Reference/Global_Objects/Object/prototype	/pt-pt/docs/conflicting/Web/JavaScript/Reference/Global_Objects/Object
/pt-pt/docs/Web/JavaScript/Reference/Operadores	/pt-pt/docs/Web/JavaScript/Reference/Operators
/pt-pt/docs/Web/JavaScript/Reference/Operadores/Operador_virgula	/pt-pt/docs/Web/JavaScript/Reference/Operators/Comma_Operator
/pt-pt/docs/Web/JavaScript/Reference/Operadores/Precedencia_operador	/pt-pt/docs/Web/JavaScript/Reference/Operators/Operator_Precedence
/pt-pt/docs/Web/JavaScript/Reference/Operadores/função	/pt-pt/docs/Web/JavaScript/Reference/Operators/function
/pt-pt/docs/Web/JavaScript/Reference/Sobre	/pt-pt/docs/Web/JavaScript/Reference/About
/pt-pt/docs/Web/MathML/Attribute/Valores	/pt-pt/docs/Web/MathML/Attribute/Values
/pt-pt/docs/Web/MathML/Examples/Derivar_a_Formula_Resolvente	/pt-pt/docs/Web/MathML/Examples/Deriving_the_Quadratic_Formula
/pt-pt/docs/Web/MathML/Examples/MathML_teorema_de_Pitagoras	/pt-pt/docs/Web/MathML/Examples/MathML_Pythagorean_Theorem
/pt-pt/docs/Web/Progressive_web_apps/Guia_de_programacao	/pt-pt/docs/Web/Progressive_web_apps/Developer_guide
/pt-pt/docs/Web/Progressive_web_apps/Responsivo/Elementos_base_desenho_adaptavel	/pt-pt/docs/Web/Progressive_web_apps/Responsive/responsive_design_building_blocks
/pt-pt/docs/Web/SVG/Aplicar_efeitos_SVG_conteudo_HTML	/pt-pt/docs/Web/SVG/Applying_SVG_effects_to_HTML_content
/pt-pt/docs/Web/SVG/Namespaces_Crash_Course/Exemplo	/pt-pt/docs/Web/SVG/Namespaces_Crash_Course/Example
/pt-pt/docs/Web/SVG/SVG_animacao_com_SMIL	/pt-pt/docs/Web/SVG/SVG_animation_with_SMIL
/pt-pt/docs/Web/SVG/Tutorial/Introducao	/pt-pt/docs/Web/SVG/Tutorial/Introduction
/pt-pt/docs/Web/SVG/Tutorial/SVG_na_Introducao_HTML	/pt-pt/docs/Web/SVG/Tutorial/SVG_In_HTML_Introduction
/pt-pt/docs/Web/Security/Conteudo_misto	/pt-pt/docs/Web/Security/Mixed_content
/pt-pt/docs/Web/Security/Mixed_content/Como_corrigir_um_site_da_Web_com_conteudo_misto_bloqueado	/pt-pt/docs/Web/Security/Mixed_content/How_to_fix_website_with_mixed_content
/pt-pt/docs/Web/Seguranca	/pt-pt/docs/Web/Security
/pt-pt/docs/Web/Seguranca/Palavras-passe_inseguras	/pt-pt/docs/Web/Security/Insecure_passwords
/pt-pt/docs/Web/Seguranca/Same-origin_policy	/pt-pt/docs/Web/Security/Same-origin_policy
/pt-pt/docs/Web/Tutoriais	/pt-pt/docs/Web/Tutorials
/pt-pt/docs/Web/WebAPI	/pt-pt/docs/conflicting/Web/API
/pt-pt/docs/WebAssembly/Utilizar_API_JavaScript_WebAssembly	/pt-pt/docs/WebAssembly/Using_the_JavaScript_API
/pt-pt/docs/XForms	/pt-pt/docs/orphaned/XForms
/pt-pt/docs/XForms_especiais_para_Mozilla	/pt-pt/docs/orphaned/XForms_especiais_para_Mozilla
/pt-pt/docs/XHTML	/pt-pt/docs/Glossary/XHTML
/pt-pt/docs/XMLHttpRequest	/pt-pt/docs/conflicting/Web/API/XMLHttpRequest
/pt-pt/docs/XML_no_Mozilla	/pt-pt/docs/orphaned/XML_no_Mozilla
