# FROM-URL	TO-URL
/es/docs/AJAX	/es/docs/Web/Guide/AJAX
/es/docs/AJAX/Comunidad	/es/docs/Web/Guide/AJAX/Comunidad
/es/docs/AJAX/Primeros_Pasos	/es/docs/Web/Guide/AJAX/Primeros_Pasos
/es/docs/AJAX:Comunidad	/es/docs/Web/Guide/AJAX/Comunidad
/es/docs/AJAX:Primeros_Pasos	/es/docs/Web/Guide/AJAX/Primeros_Pasos
/es/docs/Accesibilidad	/es/docs/Web/Accesibilidad
/es/docs/Accesibilidad/Comunidad	/es/docs/Web/Accesibilidad/Comunidad
/es/docs/Accesibilidad:Comunidad	/es/docs/Web/Accesibilidad/Comunidad
/es/docs/Accessibility	/es/docs/Web/Accesibilidad
/es/docs/Aplicaciones	/es/docs/Web/Aplicaciones
/es/docs/Aplicaciones/API_JavaScript_de_aplicaciones	/es/docs/Web/Aplicaciones/API_JavaScript_de_aplicaciones
/es/docs/Aplicaciones/Aplicaciones_para_Android	/es/docs/Web/Aplicaciones/Aplicaciones_para_Android
/es/docs/Aplicaciones/Apps_JavaScript_API	/es/docs/Web/Aplicaciones/Apps_JavaScript_API
/es/docs/Aplicaciones/Arquitectura_de_aplicaciones	/es/docs/Web/Aplicaciones/Build/Arquitectura_de_aplicaciones
/es/docs/Aplicaciones/CSP	/es/docs/Web/Aplicaciones/CSP
/es/docs/Aplicaciones/Comenzando_aplicaciones	/es/docs/Web/Aplicaciones/Comenzando_aplicaciones
/es/docs/Aplicaciones/Comenzar	/es/docs/Web/Aplicaciones/Comenzando_aplicaciones
/es/docs/Aplicaciones/Comenzar_con_la_creación_de_aplicaciones	/es/docs/Web/Aplicaciones/Comenzando_aplicaciones
/es/docs/Aplicaciones/Desarrollar_aplicaciones_para_juegos	/es/docs/Web/Aplicaciones/Desarrollar_aplicaciones_para_juegos
/es/docs/Aplicaciones/Desarrollo_de_aplicaciones_para_desarrolladores_web	/es/docs/Web/Aplicaciones/Desarrollo_de_aplicaciones_para_desarrolladores_web
/es/docs/Aplicaciones/Design	/es/docs/Web/Aplicaciones/Design
/es/docs/Aplicaciones/Design/Navegacion_Adaptativa	/es/docs/Web/Aplicaciones/Design/Navegacion_Adaptativa
/es/docs/Aplicaciones/Design/Planning_your_app	/es/docs/Web/Aplicaciones/Design/Planning_your_app
/es/docs/Aplicaciones/Design_Guidelines	/es/docs/Web/Aplicaciones/Design_Guidelines
/es/docs/Aplicaciones/Detalles_especificos_de_plataforma	/es/docs/Web/Aplicaciones/Detalles_especificos_de_plataforma
/es/docs/Aplicaciones/Developing	/es/docs/Web/Aplicaciones/Build
/es/docs/Aplicaciones/Developing/Manifest	/es/docs/Web/Aplicaciones/Build/Manifest
/es/docs/Aplicaciones/FAQs	/es/docs/Web/Aplicaciones/FAQs
/es/docs/Aplicaciones/FAQs/Preguntas_Generales	/es/docs/Web/Aplicaciones/FAQs/Preguntas_Generales
/es/docs/Aplicaciones/FAQs/Sobre_aplicaciones	/es/docs/Web/Aplicaciones/FAQs/Sobre_aplicaciones
/es/docs/Aplicaciones/FAQs/Sobre_manifiestos	/es/docs/Web/Aplicaciones/FAQs/Sobre_manifiestos
/es/docs/Aplicaciones/Games	/es/docs/Web/Aplicaciones/Games
/es/docs/Aplicaciones/Games/Consideraciones_especiales	/es/docs/Web/Aplicaciones/Games/Consideraciones_especiales
/es/docs/Aplicaciones/Iniciarse	/es/docs/Web/Aplicaciones/Comenzando_aplicaciones
/es/docs/Aplicaciones/Introducción_a_la_creación_de_aplicaciones	/es/docs/Web/Aplicaciones/Introducción_a_la_creación_de_aplicaciones
/es/docs/Aplicaciones/Manifest	/es/docs/Web/Aplicaciones/Build/Manifest
/es/docs/Aplicaciones/Manifiesto	/es/docs/Web/Aplicaciones/Manifiesto
/es/docs/Aplicaciones/Para_desarrolladores_de_aplicaciones_para_dispositivos_móviles	/es/docs/Web/Aplicaciones/Para_desarrolladores_de_aplicaciones_para_dispositivos_móviles
/es/docs/Aplicaciones/Para_desarrolladores_moviles	/es/docs/Web/Aplicaciones/Para_desarrolladores_moviles
/es/docs/Aplicaciones/Para_desarrolladores_web	/es/docs/Web/Aplicaciones/Para_desarrolladores_web
/es/docs/Aplicaciones/Preguntas_frecuentes	/es/docs/Web/Aplicaciones/Preguntas_frecuentes
/es/docs/Aplicaciones/Quickstart	/es/docs/Web/Aplicaciones/Quickstart
/es/docs/Aplicaciones/Quickstart/Design	/es/docs/Web/Aplicaciones/Quickstart/Design
/es/docs/Aplicaciones/Quickstart/Design/Concept_A_great_app	/es/docs/Web/Aplicaciones/Quickstart/Design/Concept_A_great_app
/es/docs/Aplicaciones/Quickstart/Design/Pautas_UI	/es/docs/Web/Aplicaciones/Quickstart/Design/Pautas_UI
/es/docs/Aplicaciones/Quickstart/Design/Principios_de_diseño	/es/docs/Web/Aplicaciones/Quickstart/Design/Principios_de_diseño
/es/docs/Aplicaciones/Reference	/es/docs/Web/Aplicaciones/Reference
/es/docs/Aplicaciones/Reference_apps	/es/docs/Web/Aplicaciones/Reference_apps
/es/docs/Aplicaciones/Tutorials	/es/docs/Web/Aplicaciones/Tutorials
/es/docs/Aplicaciones/Tutorials/General	/es/docs/Web/Aplicaciones/Tutorials/General
/es/docs/Aplicaciones/Usar_aplicaciones_sin_conexión	/es/docs/Web/Aplicaciones/Usar_aplicaciones_sin_conexión
/es/docs/Aplicaciones/Using_apps_offline	/es/docs/Web/Aplicaciones/Using_apps_offline
/es/docs/Aplicaciones/permisos_de_las_aplicaciones	/es/docs/Web/Aplicaciones/permisos_de_las_aplicaciones
/es/docs/ArrastrarSoltar	/en-US/docs/Web/API/HTML_Drag_and_Drop_API
/es/docs/ArrastrarSoltar/Arrastrar_y_soltar	/es/docs/DragDrop/Drag_and_Drop
/es/docs/CSS	/es/docs/Web/CSS
/es/docs/CSS/-moz-force-broken-image-icon	/es/docs/Web/CSS/-moz-force-broken-image-icon
/es/docs/CSS/::selection	/es/docs/Web/CSS/::selection
/es/docs/CSS/:active	/es/docs/Web/CSS/:active
/es/docs/CSS/:default	/es/docs/Web/CSS/:default
/es/docs/CSS/:empty	/es/docs/Web/CSS/:empty
/es/docs/CSS/:first-child	/es/docs/Web/CSS/:first-child
/es/docs/CSS/:hover	/es/docs/Web/CSS/:hover
/es/docs/CSS/:invalid	/es/docs/Web/CSS/:invalid
/es/docs/CSS/:last-child	/es/docs/Web/CSS/:last-child
/es/docs/CSS/:last-of-type	/es/docs/Web/CSS/:last-of-type
/es/docs/CSS/:nth-child	/es/docs/Web/CSS/:nth-child
/es/docs/CSS/@font-face	/es/docs/Web/CSS/@font-face
/es/docs/CSS/@import	/es/docs/Web/CSS/@import
/es/docs/CSS/@keyframes	/es/docs/Web/CSS/@keyframes
/es/docs/CSS/@media	/es/docs/Web/CSS/@media
/es/docs/CSS/Comenzando_(tutorial_CSS)	/es/docs/Web/CSS/Comenzando_(tutorial_CSS)
/es/docs/CSS/Como_iniciar	/es/docs/Web/CSS/Como_iniciar
/es/docs/CSS/Como_iniciar/Por_que_usar_CSS	/es/docs/Web/CSS/Como_iniciar/Por_que_usar_CSS
/es/docs/CSS/Como_iniciar/Porqué_usar_CSS	/es/docs/Web/CSS/Como_iniciar/Por_que_usar_CSS
/es/docs/CSS/Como_iniciar/Que_es_CSS	/es/docs/Web/CSS/Como_iniciar/Que_es_CSS
/es/docs/CSS/Consultas_multimedia	/es/docs/CSS/Media_queries
/es/docs/CSS/Escribir_CSS_eficiente	/es/docs/Web/CSS/Escribir_CSS_eficiente
/es/docs/CSS/Getting_Started	/es/docs/Web/CSS/Comenzando_(tutorial_CSS)
/es/docs/CSS/Introducción	/es/docs/Web/CSS/Introducción
/es/docs/CSS/Primeros_pasos	/es/docs/Web/CSS/Primeros_pasos
/es/docs/CSS/Pseudoelementos	/es/docs/Web/CSS/Pseudoelementos
/es/docs/CSS/Selectores_atributo	/es/docs/Web/CSS/Selectores_atributo
/es/docs/CSS/Transiciones_de_CSS	/es/docs/Web/CSS/Transiciones_de_CSS
/es/docs/CSS/Usando_animaciones_CSS	/es/docs/Web/CSS/CSS_Animations/Usando_animaciones_CSS
/es/docs/CSS/Usando_gradientes_con_CSS	/es/docs/CSS/Using_CSS_gradients
/es/docs/CSS/Using_CSS_transforms	/es/docs/Web/CSS/CSS_Transforms/Using_CSS_transforms
/es/docs/CSS/Uso_de_CSS_transforms	/es/docs/Web/CSS/CSS_Transforms/Using_CSS_transforms
/es/docs/CSS/Valor_calculado	/es/docs/Web/CSS/Valor_calculado
/es/docs/CSS/Valor_inicial	/es/docs/Web/CSS/Valor_inicial
/es/docs/CSS/after	/es/docs/Web/CSS/::after
/es/docs/CSS/animation	/es/docs/Web/CSS/animation
/es/docs/CSS/animation-delay	/es/docs/Web/CSS/animation-delay
/es/docs/CSS/animation-direction	/es/docs/Web/CSS/animation-direction
/es/docs/CSS/animation-duration	/es/docs/Web/CSS/animation-duration
/es/docs/CSS/auto	/es/docs/Web/CSS/auto
/es/docs/CSS/azimuth	/es/docs/Web/CSS/azimuth
/es/docs/CSS/background	/es/docs/Web/CSS/background
/es/docs/CSS/background-attachment	/es/docs/Web/CSS/background-attachment
/es/docs/CSS/background-color	/es/docs/Web/CSS/background-color
/es/docs/CSS/background-image	/es/docs/Web/CSS/background-image
/es/docs/CSS/background-origin	/es/docs/Web/CSS/background-origin
/es/docs/CSS/background-position	/es/docs/Web/CSS/background-position
/es/docs/CSS/background-repeat	/es/docs/Web/CSS/background-repeat
/es/docs/CSS/background-size	/es/docs/Web/CSS/background-size
/es/docs/CSS/before	/es/docs/Web/CSS/::before
/es/docs/CSS/border	/es/docs/Web/CSS/border
/es/docs/CSS/border-bottom	/es/docs/Web/CSS/border-bottom
/es/docs/CSS/border-bottom-color	/es/docs/Web/CSS/border-bottom-color
/es/docs/CSS/border-bottom-style	/es/docs/Web/CSS/border-bottom-style
/es/docs/CSS/border-bottom-width	/es/docs/Web/CSS/border-bottom-width
/es/docs/CSS/border-collapse	/es/docs/Web/CSS/border-collapse
/es/docs/CSS/border-color	/es/docs/Web/CSS/border-color
/es/docs/CSS/border-image	/es/docs/Web/CSS/border-image
/es/docs/CSS/border-left	/es/docs/Web/CSS/border-left
/es/docs/CSS/border-left-color	/es/docs/Web/CSS/border-left-color
/es/docs/CSS/border-radius	/es/docs/Web/CSS/border-radius
/es/docs/CSS/border-spacing	/es/docs/Web/CSS/border-spacing
/es/docs/CSS/border-style	/es/docs/Web/CSS/border-style
/es/docs/CSS/border-width	/es/docs/Web/CSS/border-width
/es/docs/CSS/bottom	/es/docs/Web/CSS/bottom
/es/docs/CSS/box-shadow	/es/docs/Web/CSS/box-shadow
/es/docs/CSS/calc	/es/docs/Web/CSS/calc()
/es/docs/CSS/capacidad_de_animacion_de_propiedades_CSS	/es/docs/Web/CSS
/es/docs/CSS/clip	/es/docs/Web/CSS/clip
/es/docs/CSS/color	/es/docs/Web/CSS/color
/es/docs/CSS/computed_value	/es/docs/Web/CSS/Valor_calculado
/es/docs/CSS/content	/es/docs/Web/CSS/content
/es/docs/CSS/cursor	/es/docs/Web/CSS/cursor
/es/docs/CSS/direction	/es/docs/Web/CSS/direction
/es/docs/CSS/display	/es/docs/Web/CSS/display
/es/docs/CSS/float	/es/docs/Web/CSS/float
/es/docs/CSS/font	/es/docs/Web/CSS/font
/es/docs/CSS/font-family	/es/docs/Web/CSS/font-family
/es/docs/CSS/font-size	/es/docs/Web/CSS/font-size
/es/docs/CSS/font-size-adjust	/es/docs/Web/CSS/font-size-adjust
/es/docs/CSS/font-style	/es/docs/Web/CSS/font-style
/es/docs/CSS/font-variant	/es/docs/Web/CSS/font-variant
/es/docs/CSS/font-weight	/es/docs/Web/CSS/font-weight
/es/docs/CSS/height	/es/docs/Web/CSS/height
/es/docs/CSS/ime-mode	/es/docs/Web/CSS/ime-mode
/es/docs/CSS/inherit	/es/docs/Web/CSS/inherit
/es/docs/CSS/inheritance	/es/docs/Web/CSS/inheritance
/es/docs/CSS/initial	/es/docs/Web/CSS/initial
/es/docs/CSS/integer	/es/docs/Web/CSS/integer
/es/docs/CSS/left	/es/docs/Web/CSS/left
/es/docs/CSS/length	/es/docs/Web/CSS/length
/es/docs/CSS/line-height	/es/docs/Web/CSS/line-height
/es/docs/CSS/list-style	/es/docs/Web/CSS/list-style
/es/docs/CSS/list-style-image	/es/docs/Web/CSS/list-style-image
/es/docs/CSS/list-style-position	/es/docs/Web/CSS/list-style-position
/es/docs/CSS/list-style-type	/es/docs/Web/CSS/list-style-type
/es/docs/CSS/margin-right	/es/docs/Web/CSS/margin-right
/es/docs/CSS/max-height	/es/docs/Web/CSS/max-height
/es/docs/CSS/max-width	/es/docs/Web/CSS/max-width
/es/docs/CSS/min-height	/es/docs/Web/CSS/min-height
/es/docs/CSS/min-width	/es/docs/Web/CSS/min-width
/es/docs/CSS/none	/es/docs/Web/CSS/float
/es/docs/CSS/normal	/es/docs/Web/CSS/normal
/es/docs/CSS/number	/es/docs/Web/CSS/number
/es/docs/CSS/opacity	/es/docs/Web/CSS/opacity
/es/docs/CSS/overflow	/es/docs/Web/CSS/overflow
/es/docs/CSS/perspective	/es/docs/Web/CSS/perspective
/es/docs/CSS/porcentaje	/es/docs/Web/CSS/porcentaje
/es/docs/CSS/position	/es/docs/Web/CSS/position
/es/docs/CSS/right	/es/docs/Web/CSS/right
/es/docs/CSS/rtl	/es/docs/Web/CSS/rtl
/es/docs/CSS/top	/es/docs/Web/CSS/top
/es/docs/CSS/transform	/es/docs/Web/CSS/transform
/es/docs/CSS/transform-origin	/es/docs/Web/CSS/transform-origin
/es/docs/CSS/transition-delay	/es/docs/Web/CSS/transition-delay
/es/docs/CSS/vacío	/es/docs/Web/CSS/:empty
/es/docs/CSS/vertical-align	/es/docs/Web/CSS/vertical-align
/es/docs/CSS/visibility	/es/docs/Web/CSS/visibility
/es/docs/CSS/width	/es/docs/Web/CSS/width
/es/docs/CSS/z-index	/es/docs/Web/CSS/z-index
/es/docs/CSS::default	/es/docs/Web/CSS/:default
/es/docs/CSS:Comunidad	/es/docs/CSS/Comunidad
/es/docs/CSS:Media:Visual	/es/docs/CSS/Media/Visual
/es/docs/CSS:Valor_calculado	/es/docs/Web/CSS/Valor_calculado
/es/docs/CSS:Valor_inicial	/es/docs/Web/CSS/Valor_inicial
/es/docs/CSS:after	/es/docs/Web/CSS/::after
/es/docs/CSS:auto	/es/docs/Web/CSS/auto
/es/docs/CSS:azimuth	/es/docs/Web/CSS/azimuth
/es/docs/CSS:background	/es/docs/Web/CSS/background
/es/docs/CSS:background-attachment	/es/docs/Web/CSS/background-attachment
/es/docs/CSS:background-color	/es/docs/Web/CSS/background-color
/es/docs/CSS:background-image	/es/docs/Web/CSS/background-image
/es/docs/CSS:background-position	/es/docs/Web/CSS/background-position
/es/docs/CSS:background-repeat	/es/docs/Web/CSS/background-repeat
/es/docs/CSS:before	/es/docs/Web/CSS/::before
/es/docs/CSS:border	/es/docs/Web/CSS/border
/es/docs/CSS:border-bottom	/es/docs/Web/CSS/border-bottom
/es/docs/CSS:border-bottom-color	/es/docs/Web/CSS/border-bottom-color
/es/docs/CSS:border-bottom-style	/es/docs/Web/CSS/border-bottom-style
/es/docs/CSS:border-bottom-width	/es/docs/Web/CSS/border-bottom-width
/es/docs/CSS:border-collapse	/es/docs/Web/CSS/border-collapse
/es/docs/CSS:border-color	/es/docs/Web/CSS/border-color
/es/docs/CSS:border-left	/es/docs/Web/CSS/border-left
/es/docs/CSS:border-left-color	/es/docs/Web/CSS/border-left-color
/es/docs/CSS:border-spacing	/es/docs/Web/CSS/border-spacing
/es/docs/CSS:border-style	/es/docs/Web/CSS/border-style
/es/docs/CSS:border-width	/es/docs/Web/CSS/border-width
/es/docs/CSS:bottom	/es/docs/Web/CSS/bottom
/es/docs/CSS:color	/es/docs/Web/CSS/color
/es/docs/CSS:computed_value	/es/docs/Web/CSS/Valor_calculado
/es/docs/CSS:content	/es/docs/Web/CSS/content
/es/docs/CSS:cursor	/es/docs/Web/CSS/cursor
/es/docs/CSS:direction	/es/docs/Web/CSS/direction
/es/docs/CSS:display	/es/docs/Web/CSS/display
/es/docs/CSS:float	/es/docs/Web/CSS/float
/es/docs/CSS:font	/es/docs/Web/CSS/font
/es/docs/CSS:font-family	/es/docs/Web/CSS/font-family
/es/docs/CSS:font-size	/es/docs/Web/CSS/font-size
/es/docs/CSS:font-size-adjust	/es/docs/Web/CSS/font-size-adjust
/es/docs/CSS:font-style	/es/docs/Web/CSS/font-style
/es/docs/CSS:font-variant	/es/docs/Web/CSS/font-variant
/es/docs/CSS:font-weight	/es/docs/Web/CSS/font-weight
/es/docs/CSS:height	/es/docs/Web/CSS/height
/es/docs/CSS:ime-mode	/es/docs/Web/CSS/ime-mode
/es/docs/CSS:inherit	/es/docs/Web/CSS/inherit
/es/docs/CSS:inheritance	/es/docs/Web/CSS/inheritance
/es/docs/CSS:initial	/es/docs/Web/CSS/initial
/es/docs/CSS:inline	/es/docs/CSS/inline
/es/docs/CSS:integer	/es/docs/Web/CSS/integer
/es/docs/CSS:left	/es/docs/Web/CSS/left
/es/docs/CSS:length	/es/docs/Web/CSS/length
/es/docs/CSS:line-height	/es/docs/Web/CSS/line-height
/es/docs/CSS:list-style	/es/docs/Web/CSS/list-style
/es/docs/CSS:list-style-image	/es/docs/Web/CSS/list-style-image
/es/docs/CSS:list-style-position	/es/docs/Web/CSS/list-style-position
/es/docs/CSS:list-style-type	/es/docs/Web/CSS/list-style-type
/es/docs/CSS:ltr	/es/docs/CSS/ltr
/es/docs/CSS:margin-right	/es/docs/Web/CSS/margin-right
/es/docs/CSS:max-height	/es/docs/Web/CSS/max-height
/es/docs/CSS:max-width	/es/docs/Web/CSS/max-width
/es/docs/CSS:medium	/es/docs/CSS/medium
/es/docs/CSS:min-height	/es/docs/Web/CSS/min-height
/es/docs/CSS:min-width	/es/docs/Web/CSS/min-width
/es/docs/CSS:none	/es/docs/Web/CSS/float
/es/docs/CSS:normal	/es/docs/Web/CSS/normal
/es/docs/CSS:number	/es/docs/Web/CSS/number
/es/docs/CSS:position	/es/docs/Web/CSS/position
/es/docs/CSS:right	/es/docs/Web/CSS/right
/es/docs/CSS:rtl	/es/docs/Web/CSS/rtl
/es/docs/CSS:static	/es/docs/CSS/static
/es/docs/CSS:top	/es/docs/Web/CSS/top
/es/docs/CSS:vacío	/es/docs/Web/CSS/:empty
/es/docs/CSS:visibility	/es/docs/Web/CSS/visibility
/es/docs/CSS:visible	/es/docs/CSS/visible
/es/docs/CSS:width	/es/docs/Web/CSS/width
/es/docs/Clic	/en-US/docs/Template:Clic
/es/docs/Compilando_JavaXPCOM	/es/docs/Mozilla/Developer_guide/Documentación_para_la_compilación/Compilando_JavaXPCOM
/es/docs/Complementos_de_Firefox._Guia_del_desarrollador	/es/docs/Guía_para_el_desarrollador_de_agregados_para_Firefox
/es/docs/Configurar_las_opciones_de_compilación	/es/docs/Mozilla/Developer_guide/Documentación_para_la_compilación/Configurar_las_opciones_de_compilación
/es/docs/Core_JavaScript_1.5_Guide	/es/docs/Web/JavaScript/Guide
/es/docs/Core_JavaScript_1.5_Guide/Calling_Functions	/es/docs/Web/JavaScript/Guide/Funciones#Llamando_funciones
/es/docs/Core_JavaScript_1.5_Guide/Defining_Functions	/es/docs/Web/JavaScript/Guide/Funciones
/es/docs/Core_JavaScript_1.5_Guide/Operators	/es/docs/Web/JavaScript/Referencia/Operadores
/es/docs/Core_JavaScript_1.5_Guide/Operators/Special_Operators	/es/docs/Web/JavaScript/Referencia/Operadores
/es/docs/Core_JavaScript_1.5_Guide/Predefined_Core_Objects	/es/docs/Web/JavaScript/Referencia
/es/docs/Core_JavaScript_1.5_Guide/Predefined_Core_Objects/Objeto_Array	/es/docs/Web/JavaScript/Referencia/Objetos_globales/Array
/es/docs/Core_JavaScript_1.5_Guide:Calling_Functions	/es/docs/Web/JavaScript/Guide/Funciones#Llamando_funciones
/es/docs/Core_JavaScript_1.5_Guide:Creating_New_Objects:Defining_Methods	/es/docs/Core_JavaScript_1.5_Guide/Creating_New_Objects/Defining_Methods
/es/docs/Core_JavaScript_1.5_Guide:Creating_New_Objects:Defining_Properties_for_an_Object_Type	/es/docs/Core_JavaScript_1.5_Guide/Creating_New_Objects/Defining_Properties_for_an_Object_Type
/es/docs/Core_JavaScript_1.5_Guide:Creating_New_Objects:Indexing_Object_Properties	/es/docs/Core_JavaScript_1.5_Guide/Creating_New_Objects/Indexing_Object_Properties
/es/docs/Core_JavaScript_1.5_Guide:Creating_New_Objects:Using_a_Constructor_Function	/es/docs/Core_JavaScript_1.5_Guide/Creating_New_Objects/Using_a_Constructor_Function
/es/docs/Core_JavaScript_1.5_Guide:Creating_New_Objects:Using_this_for_Object_References	/es/docs/Core_JavaScript_1.5_Guide/Creating_New_Objects/Using_this_for_Object_References
/es/docs/Core_JavaScript_1.5_Guide:Defining_Functions	/es/docs/Web/JavaScript/Guide/Funciones
/es/docs/Core_JavaScript_1.5_Guide:Operators:Special_Operators	/es/docs/Web/JavaScript/Referencia/Operadores
/es/docs/Core_JavaScript_1.5_Guide:Predefined_Core_Objects:Objeto_Array	/es/docs/Web/JavaScript/Referencia/Objetos_globales/Array
/es/docs/Core_JavaScript_1.5_Reference	/es/docs/Web/JavaScript/Referencia
/es/docs/Core_JavaScript_1.5_Reference/Objects	/es/docs/Web/JavaScript/Referencia/Objetos_globales
/es/docs/Core_JavaScript_1.5_Reference/Objects/String	/es/docs/Web/JavaScript/Referencia/Objetos_globales/String
/es/docs/Core_JavaScript_1.5_Reference/Objects/String/small	/es/docs/Web/JavaScript/Referencia/Objetos_globales/String/small
/es/docs/Core_JavaScript_1.5_Reference:Objects:String:anchor	/es/docs/Core_JavaScript_1.5_Reference/Objects/String/anchor
/es/docs/Core_JavaScript_1.5_Reference:Objects:String:small	/es/docs/Web/JavaScript/Referencia/Objetos_globales/String/small
/es/docs/Creación_de_Componentes_XPCOM:Interior_del_Componente	/es/docs/Creación_de_Componentes_XPCOM/Interior_del_Componente
/es/docs/Creación_de_Componentes_XPCOM:Prefacio	/es/docs/Creación_de_Componentes_XPCOM/Prefacio
/es/docs/Creación_de_Componentes_XPCOM:Un_vistazo_de_XPCOM	/es/docs/Creación_de_Componentes_XPCOM/Un_vistazo_de_XPCOM
/es/docs/Creación_de_Componentes_XPCOM:Uso_de_Componentes_XPCOM	/es/docs/Creación_de_Componentes_XPCOM/Uso_de_Componentes_XPCOM
/es/docs/Creando_Componentes_XPCOM	/es/docs/Creación_de_Componentes_XPCOM
/es/docs/Creando_un_skin_para_Firefox	/es/docs/Creando_un_tema_para_Firefox
/es/docs/Creando_un_skin_para_Firefox:UUID	/es/docs/Creando_un_skin_para_Firefox/UUID
/es/docs/Creando_un_skin_para_Firefox:_Como_empezar	/es/docs/Creando_un_skin_para_Firefox/Como_empezar
/es/docs/Creando_un_skin_para_Firefox:install.rdf	/es/docs/Creando_un_skin_para_Firefox/install.rdf
/es/docs/Crear_una_barra_lateral_en_Firefox	/es/docs/Crear_un_panel_lateral_en_Firefox
/es/docs/Creating_a_Skin_for_Firefox:contents.rdf	/es/docs/Creating_a_Skin_for_Firefox/contents.rdf
/es/docs/Código_fuente_de_Mozilla_(CVS)	/es/docs/Mozilla/Developer_guide/Source_Code/Código_fuente_de_Mozilla_(CVS)
/es/docs/Código_fuente_de_Mozilla_(Mercurial)	/es/docs/Mozilla/Developer_guide/Source_Code/Código_fuente_de_Mozilla_(Mercurial)
/es/docs/DOM/CSS	/es/docs/Web/CSS
/es/docs/DOM/CameraCapabilities	/es/docs/Web/API/CameraCapabilities
/es/docs/DOM/CameraCapabilities.effects	/es/docs/Web/API/CameraCapabilities/effects
/es/docs/DOM/CameraCapabilities.fileFormats	/es/docs/Web/API/CameraCapabilities/fileFormats
/es/docs/DOM/CameraCapabilities.flashModes	/es/docs/Web/API/CameraCapabilities/flashModes
/es/docs/DOM/CssRule	/es/docs/Web/API/CSSRule
/es/docs/DOM/CssRule.cssText	/es/docs/Web/API/CSSRule/cssText
/es/docs/DOM/CssRule.parentStyleSheet	/es/docs/Web/API/CSSRule/parentStyleSheet
/es/docs/DOM/CssRule.selectorText	/es/docs/Web/API/CSSStyleRule/selectorText
/es/docs/DOM/CssRule.style	/es/docs/Web/API/CSSStyleRule/style
/es/docs/DOM/Document.styleSheets	/es/docs/Web/API/Document/styleSheets
/es/docs/DOM/Element.setAttribute	/es/docs/Web/API/Element/setAttribute
/es/docs/DOM/Element.style	/es/docs/Web/API/HTMLElement/style
/es/docs/DOM/HTMLAudioElement	/es/docs/Web/API/HTMLAudioElement
/es/docs/DOM/HTMLTableElement	/es/docs/Web/API/HTMLTableElement
/es/docs/DOM/Manipulating_the_browser_history	/es/docs/DOM/Manipulando_el_historial_del_navegador
/es/docs/DOM/MozSocial.closePanel	/es/docs/Web/API/MozSocial/closePanel
/es/docs/DOM/MozSocial.getAttention	/es/docs/Web/API/MozSocial/getAttention
/es/docs/DOM/MozSocial.getWorker	/es/docs/Web/API/MozSocial/getWorker
/es/docs/DOM/MozSocial.isVisible	/es/docs/Web/API/MozSocial/isVisible
/es/docs/DOM/MozSocial.openChatWindow	/es/docs/Web/API/MozSocial/openChatWindow
/es/docs/DOM/MozSocial.openPanel	/es/docs/Web/API/MozSocial/openPanel
/es/docs/DOM/Node.appendChild	/es/docs/Web/API/Node/appendChild
/es/docs/DOM/Node.textContent	/es/docs/Web/API/Node/textContent
/es/docs/DOM/Selection	/es/docs/Web/API/Selection
/es/docs/DOM/Selection/addRange	/es/docs/Web/API/Selection/addRange
/es/docs/DOM/Selection/anchorNode	/es/docs/Web/API/Selection/anchorNode
/es/docs/DOM/Selection/anchorOffset	/es/docs/Web/API/Selection/anchorOffset
/es/docs/DOM/Selection/collapse	/es/docs/Web/API/Selection/collapse
/es/docs/DOM/Selection/collapseToEnd	/es/docs/Web/API/Selection/collapseToEnd
/es/docs/DOM/Selection/collapseToStart	/es/docs/Web/API/Selection/collapseToStart
/es/docs/DOM/Selection/containsNode	/es/docs/Web/API/Selection/containsNode
/es/docs/DOM/Selection/deleteFromDocument	/es/docs/Web/API/Selection/deleteFromDocument
/es/docs/DOM/Selection/extend	/es/docs/Web/API/Selection/extend
/es/docs/DOM/Selection/focusNode	/es/docs/Web/API/Selection/focusNode
/es/docs/DOM/Selection/focusOffset	/es/docs/Web/API/Selection/focusOffset
/es/docs/DOM/Selection/getRangeAt	/es/docs/Web/API/Selection/getRangeAt
/es/docs/DOM/Selection/isCollapsed	/es/docs/Web/API/Selection/isCollapsed
/es/docs/DOM/Selection/rangeCount	/es/docs/Web/API/Selection/rangeCount
/es/docs/DOM/Selection/removeAllRanges	/es/docs/Web/API/Selection/removeAllRanges
/es/docs/DOM/Selection/removeRange	/es/docs/Web/API/Selection/removeRange
/es/docs/DOM/Selection/selectAllChildren	/es/docs/Web/API/Selection/selectAllChildren
/es/docs/DOM/Selection/toString	/es/docs/Web/API/Selection/toString
/es/docs/DOM/Style.media	/es/docs/Web/API/StyleSheet/media
/es/docs/DOM/Style.type	/es/docs/Web/API/StyleSheet/type
/es/docs/DOM/Stylesheet	/es/docs/Web/API/StyleSheet
/es/docs/DOM/Stylesheet.cssRules	/es/docs/Web/API/CSSStyleSheet/insertRule
/es/docs/DOM/Stylesheet.deleteRule	/es/docs/Web/API/CSSStyleSheet/deleteRule
/es/docs/DOM/Stylesheet.disabled	/es/docs/Web/API/StyleSheet/disabled
/es/docs/DOM/Stylesheet.href	/es/docs/Web/API/StyleSheet/href
/es/docs/DOM/Stylesheet.insertRule	/es/docs/Web/API/CSSStyleSheet/insertRule
/es/docs/DOM/Stylesheet.media	/es/docs/Web/API/StyleSheet/media
/es/docs/DOM/Stylesheet.ownerNode	/es/docs/Web/API/StyleSheet/ownerNode
/es/docs/DOM/Stylesheet.ownerRule	/es/docs/Web/API/CSSStyleSheet/ownerRule
/es/docs/DOM/Stylesheet.parentStyleSheet	/es/docs/Web/API/StyleSheet/parentStyleSheet
/es/docs/DOM/Stylesheet.title	/es/docs/Web/API/StyleSheet/title
/es/docs/DOM/Stylesheet.type	/es/docs/Web/API/StyleSheet/type
/es/docs/DOM/Stylesheet_object	/es/docs/Web/API/CSSStyleSheet
/es/docs/DOM/Window.getComputedStyle	/es/docs/Web/API/Window/getComputedStyle
/es/docs/DOM/dispatchEvent_example	/es/docs/Web/Guide/DOM/Events/Creating_and_triggering_events
/es/docs/DOM/document	/es/docs/Web/API/Document
/es/docs/DOM/document.URL	/es/docs/Web/API/Document/URL
/es/docs/DOM/document.activeElement	/es/docs/Web/API/DocumentOrShadowRoot/activeElement
/es/docs/DOM/document.alinkColor	/es/docs/Web/API/Document/alinkColor
/es/docs/DOM/document.anchors	/es/docs/Web/API/Document/anchors
/es/docs/DOM/document.applets	/es/docs/Web/API/Document/applets
/es/docs/DOM/document.bgColor	/es/docs/Web/API/Document/bgColor
/es/docs/DOM/document.body	/es/docs/Web/API/Document/body
/es/docs/DOM/document.characterSet	/es/docs/Web/API/Document/characterSet
/es/docs/DOM/document.createEvent	/es/docs/Web/API/Document/createEvent
/es/docs/DOM/document.createRange	/es/docs/Web/API/Document/createRange
/es/docs/DOM/document.documentElement	/es/docs/Web/API/Document/documentElement
/es/docs/DOM/document.documentURIObject	/es/docs/Web/API/Document/documentURIObject
/es/docs/DOM/document.elementFromPoint	/es/docs/Web/API/DocumentOrShadowRoot/elementFromPoint
/es/docs/DOM/document.firstChild	/es/docs/Web/API/Node.firstChild
/es/docs/DOM/document.getElementById	/es/docs/Web/API/Document/getElementById
/es/docs/DOM/document.getElementsByTagName	/es/docs/Web/API/Document/getElementsByTagName
/es/docs/DOM/document.getElementsByTagNameNS	/es/docs/Web/API/Document/getElementsByTagNameNS
/es/docs/DOM/document.hasFocus	/es/docs/Web/API/Document/hasFocus
/es/docs/DOM/element	/es/docs/Web/API/Element
/es/docs/DOM/element.activeElement	/es/docs/Web/API/DocumentOrShadowRoot/activeElement
/es/docs/DOM/element.clientLeft	/es/docs/Web/API/Element/clientLeft
/es/docs/DOM/element.clientTop	/es/docs/Web/API/Element/clientTop
/es/docs/DOM/element.dispatchEvent	/es/docs/Web/API/EventTarget/dispatchEvent
/es/docs/DOM/element.getBoundingClientRect	/es/docs/Web/API/Element/getBoundingClientRect
/es/docs/DOM/element.getClientRects	/es/docs/Web/API/Element/getClientRects
/es/docs/DOM/element.getElementsByTagName	/es/docs/Web/API/Element/getElementsByTagName
/es/docs/DOM/element.hasFocus	/es/docs/Web/API/Document/hasFocus
/es/docs/DOM/element.innerHTML	/es/docs/Web/API/Element/innerHTML
/es/docs/DOM/element.nodeName	/es/docs/Web/API/Node/nodeName
/es/docs/DOM/element.tagName	/es/docs/Web/API/Element/tagName
/es/docs/DOM/elemento.addEventListener	/es/docs/Web/API/EventTarget/addEventListener
/es/docs/DOM/event	/es/docs/Web/API/Event
/es/docs/DOM/event.bubbles	/es/docs/Web/API/Event/bubbles
/es/docs/DOM/event.cancelable	/es/docs/Web/API/Event/cancelable
/es/docs/DOM/event.initEvent	/es/docs/Web/API/Event/initEvent
/es/docs/DOM/event.initMouseEvent	/es/docs/Web/API/MouseEvent/initMouseEvent
/es/docs/DOM/event.pageX	/es/docs/Web/API/UIEvent/pageX
/es/docs/DOM/event.preventDefault	/es/docs/Web/API/Event/preventDefault
/es/docs/DOM/event.type	/es/docs/Web/API/Event/type
/es/docs/DOM/form	/es/docs/Web/API/HTMLFormElement
/es/docs/DOM/navegador.id	/es/docs/Web/API/Navigator/id
/es/docs/DOM/navigator.id	/es/docs/Web/API/Navigator/id
/es/docs/DOM/navigator.mozSocial	/es/docs/Web/API/Navigator/mozSocial
/es/docs/DOM/range	/es/docs/Web/API/Range
/es/docs/DOM/range.collapsed	/es/docs/Web/API/Range/collapsed
/es/docs/DOM/range.commonAncestorContainer	/es/docs/Web/API/Range/commonAncestorContainer
/es/docs/DOM/range.intersectsNode	/es/docs/Web/API/Range/intersectsNode
/es/docs/DOM/style	/es/docs/Web/API/HTMLStyleElement
/es/docs/DOM/table	/es/docs/Web/API/HTMLTableElement
/es/docs/DOM/window	/es/docs/Web/API/Window
/es/docs/DOM/window.applicationCache	/es/docs/Web/API/Window/applicationCache
/es/docs/DOM/window.fullScreen	/es/docs/Web/API/Window/fullScreen
/es/docs/DOM/window.getSelection	/es/docs/Web/API/Window/getSelection
/es/docs/DOM/window.navigator.geolocation	/es/docs/Web/API/NavigatorGeolocation/geolocation
/es/docs/DOM/window.navigator.registerProtocolHandler	/es/docs/Web/API/Navigator/registerProtocolHandler
/es/docs/DOM/window.navigator.vibrate	/es/docs/Web/API/Navigator/vibrate
/es/docs/DOM/window.onload	/es/docs/Web/API/GlobalEventHandlers/onload
/es/docs/DOM/window.onunload	/es/docs/Web/API/GlobalEventHandlers/onunload
/es/docs/DOM/window.requestAnimationFrame	/es/docs/Web/API/Window/requestAnimationFrame
/es/docs/DOM:Almacenamiento	/es/docs/DOM/Almacenamiento
/es/docs/DOM:Comunidad	/es/docs/DOM/Comunidad
/es/docs/DOM:Selection:addRange	/es/docs/Web/API/Selection/addRange
/es/docs/DOM:Selection:anchorNode	/es/docs/Web/API/Selection/anchorNode
/es/docs/DOM:Selection:anchorOffset	/es/docs/Web/API/Selection/anchorOffset
/es/docs/DOM:Selection:collapse	/es/docs/Web/API/Selection/collapse
/es/docs/DOM:Selection:collapseToEnd	/es/docs/Web/API/Selection/collapseToEnd
/es/docs/DOM:Selection:collapseToStart	/es/docs/Web/API/Selection/collapseToStart
/es/docs/DOM:Selection:containsNode	/es/docs/Web/API/Selection/containsNode
/es/docs/DOM:Selection:deleteFromDocument	/es/docs/Web/API/Selection/deleteFromDocument
/es/docs/DOM:Selection:extend	/es/docs/Web/API/Selection/extend
/es/docs/DOM:Selection:focusNode	/es/docs/Web/API/Selection/focusNode
/es/docs/DOM:Selection:focusOffset	/es/docs/Web/API/Selection/focusOffset
/es/docs/DOM:Selection:getRangeAt	/es/docs/Web/API/Selection/getRangeAt
/es/docs/DOM:Selection:isCollapsed	/es/docs/Web/API/Selection/isCollapsed
/es/docs/DOM:Selection:rangeCount	/es/docs/Web/API/Selection/rangeCount
/es/docs/DOM:Selection:removeAllRanges	/es/docs/Web/API/Selection/removeAllRanges
/es/docs/DOM:Selection:removeRange	/es/docs/Web/API/Selection/removeRange
/es/docs/DOM:Selection:selectAllChildren	/es/docs/Web/API/Selection/selectAllChildren
/es/docs/DOM:Selection:toString	/es/docs/Web/API/Selection/toString
/es/docs/DOM:dispatchEvent_example	/es/docs/Web/Guide/DOM/Events/Creating_and_triggering_events
/es/docs/DOM:document	/es/docs/Web/API/Document
/es/docs/DOM:document.URL	/es/docs/Web/API/Document/URL
/es/docs/DOM:document.activeElement	/es/docs/Web/API/DocumentOrShadowRoot/activeElement
/es/docs/DOM:document.alinkColor	/es/docs/Web/API/Document/alinkColor
/es/docs/DOM:document.anchors	/es/docs/Web/API/Document/anchors
/es/docs/DOM:document.applets	/es/docs/Web/API/Document/applets
/es/docs/DOM:document.bgColor	/es/docs/Web/API/Document/bgColor
/es/docs/DOM:document.body	/es/docs/Web/API/Document/body
/es/docs/DOM:document.characterSet	/es/docs/Web/API/Document/characterSet
/es/docs/DOM:document.cookie	/es/docs/DOM/document.cookie
/es/docs/DOM:document.createEvent	/es/docs/Web/API/Document/createEvent
/es/docs/DOM:document.createRange	/es/docs/Web/API/Document/createRange
/es/docs/DOM:document.documentElement	/es/docs/Web/API/Document/documentElement
/es/docs/DOM:document.documentURIObject	/es/docs/Web/API/Document/documentURIObject
/es/docs/DOM:document.elementFromPoint	/es/docs/Web/API/DocumentOrShadowRoot/elementFromPoint
/es/docs/DOM:document.firstChild	/es/docs/Web/API/Node.firstChild
/es/docs/DOM:document.getElementById	/es/docs/Web/API/Document/getElementById
/es/docs/DOM:document.getElementsByTagName	/es/docs/Web/API/Document/getElementsByTagName
/es/docs/DOM:document.getElementsByTagNameNS	/es/docs/Web/API/Document/getElementsByTagNameNS
/es/docs/DOM:document.hasFocus	/es/docs/Web/API/Document/hasFocus
/es/docs/DOM:element	/es/docs/Web/API/Element
/es/docs/DOM:element.activeElemen	/es/docs/DOM/element.activeElemen
/es/docs/DOM:element.activeElement	/es/docs/Web/API/DocumentOrShadowRoot/activeElement
/es/docs/DOM:element.clientLeft	/es/docs/Web/API/Element/clientLeft
/es/docs/DOM:element.clientTop	/es/docs/Web/API/Element/clientTop
/es/docs/DOM:element.dispatchEvent	/es/docs/Web/API/EventTarget/dispatchEvent
/es/docs/DOM:element.getBoundingClientRect	/es/docs/Web/API/Element/getBoundingClientRect
/es/docs/DOM:element.getClientRects	/es/docs/Web/API/Element/getClientRects
/es/docs/DOM:element.getElementsByTagName	/es/docs/Web/API/Element/getElementsByTagName
/es/docs/DOM:element.hasFocus	/es/docs/Web/API/Document/hasFocus
/es/docs/DOM:element.nodeName	/es/docs/Web/API/Node/nodeName
/es/docs/DOM:element.tagName	/es/docs/Web/API/Element/tagName
/es/docs/DOM:event	/es/docs/Web/API/Event
/es/docs/DOM:event.bubbles	/es/docs/Web/API/Event/bubbles
/es/docs/DOM:event.cancelable	/es/docs/Web/API/Event/cancelable
/es/docs/DOM:event.initEvent	/es/docs/Web/API/Event/initEvent
/es/docs/DOM:event.initMouseEvent	/es/docs/Web/API/MouseEvent/initMouseEvent
/es/docs/DOM:event.pageX	/es/docs/Web/API/UIEvent/pageX
/es/docs/DOM:event.preventDefault	/es/docs/Web/API/Event/preventDefault
/es/docs/DOM:form	/es/docs/Web/API/HTMLFormElement
/es/docs/DOM:range	/es/docs/Web/API/Range
/es/docs/DOM:range.cloneContents	/es/docs/DOM/range.cloneContents
/es/docs/DOM:range.cloneRange	/es/docs/DOM/range.cloneRange
/es/docs/DOM:range.collapse	/es/docs/DOM/range.collapse
/es/docs/DOM:range.collapsed	/es/docs/Web/API/Range/collapsed
/es/docs/DOM:range.commonAncestorContainer	/es/docs/Web/API/Range/commonAncestorContainer
/es/docs/DOM:range.compareBoundaryPoints	/es/docs/DOM/range.compareBoundaryPoints
/es/docs/DOM:range.compareNode	/es/docs/DOM/range.compareNode
/es/docs/DOM:range.comparePoint	/es/docs/DOM/range.comparePoint
/es/docs/DOM:range.createContextualFragment	/es/docs/DOM/range.createContextualFragment
/es/docs/DOM:range.deleteContents	/es/docs/DOM/range.deleteContents
/es/docs/DOM:range.detach	/es/docs/DOM/range.detach
/es/docs/DOM:range.endContainer	/es/docs/DOM/range.endContainer
/es/docs/DOM:range.endOffset	/es/docs/DOM/range.endOffset
/es/docs/DOM:range.extractContents	/es/docs/DOM/range.extractContents
/es/docs/DOM:range.insertNode	/es/docs/DOM/range.insertNode
/es/docs/DOM:range.intersectsNode	/es/docs/Web/API/Range/intersectsNode
/es/docs/DOM:range.isPointInRange	/es/docs/DOM/range.isPointInRange
/es/docs/DOM:range.selectNode	/es/docs/DOM/range.selectNode
/es/docs/DOM:range.selectNodeContents	/es/docs/DOM/range.selectNodeContents
/es/docs/DOM:range.setEnd	/es/docs/DOM/range.setEnd
/es/docs/DOM:range.setEndAfter	/es/docs/DOM/range.setEndAfter
/es/docs/DOM:range.setEndBefore	/es/docs/DOM/range.setEndBefore
/es/docs/DOM:range.setStart	/es/docs/DOM/range.setStart
/es/docs/DOM:range.setStartAfter	/es/docs/DOM/range.setStartAfter
/es/docs/DOM:range.setStartBefore	/es/docs/DOM/range.setStartBefore
/es/docs/DOM:range.startContainer	/es/docs/DOM/range.startContainer
/es/docs/DOM:range.startOffset	/es/docs/DOM/range.startOffset
/es/docs/DOM:range.surroundContents	/es/docs/DOM/range.surroundContents
/es/docs/DOM:range.toString	/es/docs/DOM/range.toString
/es/docs/DOM:selection	/es/docs/Web/API/Selection
/es/docs/DOM:style	/es/docs/Web/API/HTMLStyleElement
/es/docs/DOM:table	/es/docs/Web/API/HTMLTableElement
/es/docs/DOM:window	/es/docs/Web/API/Window
/es/docs/DOM:window.applicationCache	/es/docs/Web/API/Window/applicationCache
/es/docs/DOM:window.fullScreen	/es/docs/Web/API/Window/fullScreen
/es/docs/DOM:window.getSelection	/es/docs/Web/API/Window/getSelection
/es/docs/DOM:window.navigator.registerProtocolHandler	/es/docs/Web/API/Navigator/registerProtocolHandler
/es/docs/DOM_Client_Object_Cross-Reference:navigator	/es/docs/DOM_Client_Object_Cross-Reference/navigator
/es/docs/Desarrollo_Web:Comunidad	/es/docs/Desarrollo_Web/Comunidad
/es/docs/Descargar_el_código_fuente_de_Mozilla	/es/docs/Mozilla/Developer_guide/Source_Code/Descargar_el_código_fuente_de_Mozilla
/es/docs/Detección_del_navegador_y_soporte_entre_ellos	/es/docs/Detección_del_navegador_y_cobertura_a_múltiples_navegadores
/es/docs/Developer_Guide	/es/docs/Mozilla/Developer_guide
/es/docs/Developer_Guide/Source_Code	/es/docs/Mozilla/Developer_guide/Source_Code
/es/docs/Documentación_de_compilado	/es/docs/Mozilla/Developer_guide/Documentación_para_la_compilación
/es/docs/Documentación_para_la_compilación	/es/docs/Mozilla/Developer_guide/Documentación_para_la_compilación
/es/docs/Documentación_para_la_compilación:TOC	/es/docs/Documentación_para_la_compilación/TOC
/es/docs/Drawing_text_using_a_canvas	/es/docs/Dibujar_texto_usando_canvas
/es/docs/EXSLT	/es/docs/Web/EXSLT
/es/docs/EXSLT/exsl	/es/docs/Web/EXSLT/exsl
/es/docs/EXSLT/exsl/node-set	/es/docs/Web/EXSLT/exsl/node-set
/es/docs/EXSLT/exsl/object-type	/es/docs/Web/EXSLT/exsl/object-type
/es/docs/EXSLT/math	/es/docs/Web/EXSLT/math
/es/docs/EXSLT/math/highest	/es/docs/Web/EXSLT/math/highest
/es/docs/EXSLT/math/lowest	/es/docs/Web/EXSLT/math/lowest
/es/docs/EXSLT/math/max	/es/docs/Web/EXSLT/math/max
/es/docs/EXSLT/math/min	/es/docs/Web/EXSLT/math/min
/es/docs/EXSLT/regexp	/es/docs/Web/EXSLT/regexp
/es/docs/EXSLT/regexp/match	/es/docs/Web/EXSLT/regexp/match
/es/docs/EXSLT/regexp/replace	/es/docs/Web/EXSLT/regexp/replace
/es/docs/EXSLT/regexp/test	/es/docs/Web/EXSLT/regexp/test
/es/docs/EXSLT/set	/es/docs/Web/EXSLT/set
/es/docs/EXSLT/set/difference	/es/docs/Web/EXSLT/set/difference
/es/docs/EXSLT/set/distinct	/es/docs/Web/EXSLT/set/distinct
/es/docs/EXSLT/set/has-same-node	/es/docs/Web/EXSLT/set/has-same-node
/es/docs/EXSLT/set/intersection	/es/docs/Web/EXSLT/set/intersection
/es/docs/EXSLT/set/leading	/es/docs/Web/EXSLT/set/leading
/es/docs/EXSLT/set/trailing	/es/docs/Web/EXSLT/set/trailing
/es/docs/EXSLT/str	/es/docs/Web/EXSLT/str
/es/docs/EXSLT/str/concat	/es/docs/Web/EXSLT/str/concat
/es/docs/EXSLT/str/split	/es/docs/Web/EXSLT/str/split
/es/docs/EXSLT/str/tokenize	/es/docs/Web/EXSLT/str/tokenize
/es/docs/EXSLT:exsl:node-set	/es/docs/Web/EXSLT/exsl/node-set
/es/docs/EXSLT:exsl:object-type	/es/docs/Web/EXSLT/exsl/object-type
/es/docs/EXSLT:math:highest	/es/docs/Web/EXSLT/math/highest
/es/docs/EXSLT:math:lowest	/es/docs/Web/EXSLT/math/lowest
/es/docs/EXSLT:math:max	/es/docs/Web/EXSLT/math/max
/es/docs/EXSLT:math:min	/es/docs/Web/EXSLT/math/min
/es/docs/EXSLT:regexp:match	/es/docs/Web/EXSLT/regexp/match
/es/docs/EXSLT:regexp:replace	/es/docs/Web/EXSLT/regexp/replace
/es/docs/EXSLT:regexp:test	/es/docs/Web/EXSLT/regexp/test
/es/docs/EXSLT:set:difference	/es/docs/Web/EXSLT/set/difference
/es/docs/EXSLT:set:distinct	/es/docs/Web/EXSLT/set/distinct
/es/docs/EXSLT:set:has-same-node	/es/docs/Web/EXSLT/set/has-same-node
/es/docs/EXSLT:set:intersection	/es/docs/Web/EXSLT/set/intersection
/es/docs/EXSLT:set:leading	/es/docs/Web/EXSLT/set/leading
/es/docs/EXSLT:set:trailing	/es/docs/Web/EXSLT/set/trailing
/es/docs/EXSLT:str:concat	/es/docs/Web/EXSLT/str/concat
/es/docs/EXSLT:str:split	/es/docs/Web/EXSLT/str/split
/es/docs/EXSLT:str:tokenize	/es/docs/Web/EXSLT/str/tokenize
/es/docs/Errores_notables_corregidos_en_Firefox_3	/es/docs/Bugs_importantes_solucionados_en_Firefox_3
/es/docs/Escribir_CSS_eficaz	/es/docs/Web/CSS/Escribir_CSS_eficiente
/es/docs/Escribir_CSS_eficiente	/es/docs/Web/CSS/Escribir_CSS_eficiente
/es/docs/Estándares_Web:Comunidad	/es/docs/Estándares_Web/Comunidad
/es/docs/Eventos_online_y_offline	/es/docs/Web/API/NavigatorOnLine/Eventos_online_y_offline
/es/docs/Extensiones:Comunidad	/es/docs/Extensiones/Comunidad
/es/docs/Extensión_Firebug_(externo)	https://addons.mozilla.org/extensions/moreinfo.php?id=1843&application=firefox
/es/docs/FUEL:Annotations	/es/docs/FUEL/Annotations
/es/docs/FUEL:Application	/es/docs/FUEL/Application
/es/docs/FUEL:Bookmark	/es/docs/FUEL/Bookmark
/es/docs/FUEL:BookmarkFolder	/es/docs/FUEL/BookmarkFolder
/es/docs/FUEL:BrowserTab	/es/docs/FUEL/BrowserTab
/es/docs/FUEL:Console	/es/docs/FUEL/Console
/es/docs/FUEL:EventItem	/es/docs/FUEL/EventItem
/es/docs/FUEL:EventListener	/es/docs/FUEL/EventListener
/es/docs/FUEL:Events	/es/docs/FUEL/Events
/es/docs/FUEL:Extension	/es/docs/FUEL/Extension
/es/docs/FUEL:Extensions	/es/docs/FUEL/Extensions
/es/docs/FUEL:Preference	/es/docs/FUEL/Preference
/es/docs/FUEL:PreferenceBranch	/es/docs/FUEL/PreferenceBranch
/es/docs/FUEL:SessionStorage	/es/docs/FUEL/SessionStorage
/es/docs/FUEL:Window	/es/docs/FUEL/Window
/es/docs/Firefox_1.5	/es/docs/Firefox_1.5_para_Desarrolladores
/es/docs/Firefox_2	/es/docs/Firefox_2_para_desarrolladores
/es/docs/Firefox_3.1_para_desarrolladores	/es/docs/Firefox_3.5_para_desarrolladores
/es/docs/Firefox_3.5_para_desarrolladores/Firefox_3.1_para_desarrolladores	/es/docs/Firefox_3.5_para_desarrolladores
/es/docs/Firefox_3.5_para_desarrolladores/Firefox_3.5_para_desarrolladores	/es/docs/Firefox_3.5_para_desarrolladores
/es/docs/Firefox_3_para_desarrolladores:Traducciones_pendientes	/es/docs/Firefox_3_para_desarrolladores/Traducciones_pendientes
/es/docs/Firefox_addons_developer_guide/Introduction_to_Extensions-redirect-1	/es/docs/Firefox_addons_developer_guide/Introduction_to_Extensions
/es/docs/Firefox_en_Android	/es/docs/Mozilla/Firefox_para_Android
/es/docs/Firefox_para_desarrolladores	/en-US/docs/Firefox_10_para_desarrolladores
/es/docs/Garantía_de_Calidad	/es/docs/QA
/es/docs/Gestión_del_foco_en_HTML	/es/docs/Web/API/Document/hasFocus
/es/docs/Glossary/AOM	/es/docs/Glossary/Accessibility_tree
/es/docs/Glossary/undefined_es	/es/docs/Glossary/undefined
/es/docs/Guía_JavaScript_1.5	/es/docs/Web/JavaScript/Guide
/es/docs/Guía_JavaScript_1.5/Acerca_de_esta_guía	/es/docs/Web/JavaScript/Guide/Introducción
/es/docs/Guía_JavaScript_1.5/Concepto_de_JavaScript	/es/docs/Web/JavaScript/Guide/Introducción
/es/docs/Guía_JavaScript_1.5/Constantes	/es/docs/Web/JavaScript/Referencia/Sentencias/const
/es/docs/Guía_JavaScript_1.5/Crear_nuevos_objetos	/es/docs/Web/JavaScript/Guide/Trabajando_con_objectos#Creando_nuevos_objetos
/es/docs/Guía_JavaScript_1.5/Crear_nuevos_objetos/Borrando_propiedades	/es/docs/Web/JavaScript/Guide/Trabajando_con_objectos#Eliminando_propiedades
/es/docs/Guía_JavaScript_1.5/Crear_nuevos_objetos/Definiendo_las_funciones_get_y_set	/es/docs/Web/JavaScript/Guide/Trabajando_con_objectos#Definiendo_getters_y_setters
/es/docs/Guía_JavaScript_1.5/Crear_nuevos_objetos/Definiendo_los_métodos	/es/docs/Web/JavaScript/Guide/Trabajando_con_objectos#Definiendo_los_m.C3.A9todos
/es/docs/Guía_JavaScript_1.5/Crear_nuevos_objetos/Definiendo_propiedades_para_un_tipo_de_objeto	/es/docs/Web/JavaScript/Guide/Trabajando_con_objectos#Definici.C3.B3n_de_las_propiedades_de_un_tipo_de_objeto
/es/docs/Guía_JavaScript_1.5/Crear_nuevos_objetos/Indexando_las_propiedades_del_objeto	/es/docs/Web/JavaScript/Guide/Trabajando_con_objectos#Propiedades_del_objeto_indexado
/es/docs/Guía_JavaScript_1.5/Crear_nuevos_objetos/Usando_this_para_referirse_al_objeto	/es/docs/Web/JavaScript/Guide/Trabajando_con_objectos#Usando_this_para_las_referencias_a_objetos
/es/docs/Guía_JavaScript_1.5/Crear_nuevos_objetos/Usando_una_función_constructora	/es/docs/Web/JavaScript/Guide/Trabajando_con_objectos#Usando_una_funci.C3.B3n_constructora
/es/docs/Guía_JavaScript_1.5/Crear_nuevos_objetos/Using_Object_Initializers	/es/docs/Web/JavaScript/Guide/Trabajando_con_objectos#El_uso_de_inicializadores_de_objeto
/es/docs/Guía_JavaScript_1.5/Crear_nuevos_objetos/Utilizando_Objetos_Iniciadores	/es/docs/Web/JavaScript/Guide/Trabajando_con_objectos#El_uso_de_inicializadores_de_objeto
/es/docs/Guía_JavaScript_1.5/Crear_una_expresión_regular	/es/docs/Web/JavaScript/Guide/Regular_Expressions
/es/docs/Guía_JavaScript_1.5/Definiendo_Funciones	/es/docs/Web/JavaScript/Guide/Funciones
/es/docs/Guía_JavaScript_1.5/El_ejemplo_Empleado	/es/docs/Web/JavaScript/Guide/Details_of_the_Object_Model#Ejemplo.3A_employee
/es/docs/Guía_JavaScript_1.5/El_ejemplo_Employee	/es/docs/Web/JavaScript/Guide/Details_of_the_Object_Model#Ejemplo.3A_employee
/es/docs/Guía_JavaScript_1.5/El_ejemplo_Employee/Constructores_más_flexibles	/es/docs/Web/JavaScript/Guide/Details_of_the_Object_Model#Constructores_mas_flexibles
/es/docs/Guía_JavaScript_1.5/El_ejemplo_Employee/Creando_la_jerarquía	/es/docs/Web/JavaScript/Guide/Details_of_the_Object_Model#Creacion_de_la_jerarquia
/es/docs/Guía_JavaScript_1.5/El_ejemplo_Employee/Propiedades_de_objetos	/es/docs/Web/JavaScript/Guide/Details_of_the_Object_Model#Propiedades_de_objetos
/es/docs/Guía_JavaScript_1.5/El_ejemplo_Employee/Propiedades_de_objetos/Añadiendo_propiedades	/es/docs/Web/JavaScript/Guide/Details_of_the_Object_Model#A.C3.B1adir_propiedades
/es/docs/Guía_JavaScript_1.5/El_ejemplo_Employee/Propiedades_de_objetos/Heredando_las_propiedades	/es/docs/Web/JavaScript/Guide/Details_of_the_Object_Model#Herencia_de_propiedades
/es/docs/Guía_JavaScript_1.5/Escribir_un_patrón_de_expresión_regular	/es/docs/Web/JavaScript/Guide/Regular_Expressions
/es/docs/Guía_JavaScript_1.5/Excepción_del_DOM	/es/docs/Web/API/DOMException
/es/docs/Guía_JavaScript_1.5/Expresiones	/es/docs/Web/JavaScript/Guide/Expressions_and_Operators
/es/docs/Guía_JavaScript_1.5/Expresiones_Regulares	/es/docs/Web/JavaScript/Guide/Regular_Expressions
/es/docs/Guía_JavaScript_1.5/Expresiones_y_operadores	/es/docs/Web/JavaScript/Guide/Expressions_and_Operators
/es/docs/Guía_JavaScript_1.5/Funciones_predefinidas	/es/docs/Web/JavaScript/Guide/Funciones#Predefined_functions
/es/docs/Guía_JavaScript_1.5/Funciones_predefinidas/Funciones_Number_y_String	/es/docs/Web/JavaScript/Guide/Funciones#Number_and_String_functions
/es/docs/Guía_JavaScript_1.5/Funciones_predefinidas/Funciones_escape_y_unescape	/es/docs/Web/JavaScript/Guide/Funciones#escape_and_unescape_functions(Obsoleted_above_JavaScript_1.5)
/es/docs/Guía_JavaScript_1.5/Funciones_predefinidas/Funciones_parseInt_y_parseFloat	/es/docs/Web/JavaScript/Guide/Funciones#parseInt_and_parseFloat_functions
/es/docs/Guía_JavaScript_1.5/Funciones_predefinidas/Función_eval	/es/docs/Web/JavaScript/Guide/Funciones#eval_Function
/es/docs/Guía_JavaScript_1.5/Funciones_predefinidas/Función_isFinite	/es/docs/Web/JavaScript/Guide/Funciones#isFinite_function
/es/docs/Guía_JavaScript_1.5/Funciones_predefinidas/Función_isNaN	/es/docs/Web/JavaScript/Guide/Funciones#isNaN_function
/es/docs/Guía_JavaScript_1.5/Lenguajes_basados_en_clases_frente_a_basados_en_prototipos	/es/docs/Web/JavaScript/Guide/Details_of_the_Object_Model
/es/docs/Guía_JavaScript_1.5/Literales	/es/docs/Web/JavaScript/Guide/Grammar_and_types#Literales
/es/docs/Guía_JavaScript_1.5/Llamando_Funciones	/es/docs/Web/JavaScript/Guide/Funciones#Llamando_funciones
/es/docs/Guía_JavaScript_1.5/Más_sobre_la_herencia_de_propiedades	/es/docs/Web/JavaScript/Guide/Details_of_the_Object_Model#Mas_sobre_herencia_de_propiedades
/es/docs/Guía_JavaScript_1.5/Más_sobre_la_herencia_de_propiedades/Determinando_relaciones_de_instancia	/es/docs/Web/JavaScript/Guide/Details_of_the_Object_Model#Como_determinar_las_relaciones_entre_instancias
/es/docs/Guía_JavaScript_1.5/Más_sobre_la_herencia_de_propiedades/Herencia_no_múltiple	/es/docs/Web/JavaScript/Guide/Details_of_the_Object_Model#No_existe_herencia_multiple
/es/docs/Guía_JavaScript_1.5/Más_sobre_la_herencia_de_propiedades/Información_global_en_los_constructores	/es/docs/Web/JavaScript/Guide/Details_of_the_Object_Model#Informacion_global_en_los_constructores
/es/docs/Guía_JavaScript_1.5/Más_sobre_la_herencia_de_propiedades/Valores_locales_frente_a_los_heredados	/es/docs/Web/JavaScript/Guide/Details_of_the_Object_Model#Valores_locales_frente_a_valores_heredados
/es/docs/Guía_JavaScript_1.5/Objetos_base_predefinidos	/es/docs/Web/JavaScript/Referencia
/es/docs/Guía_JavaScript_1.5/Objetos_base_predefinidos/Objeto_Array	/es/docs/Web/JavaScript/Referencia/Objetos_globales/Array
/es/docs/Guía_JavaScript_1.5/Objetos_base_predefinidos/Objeto_Boolean	/es/docs/Web/JavaScript/Referencia/Objetos_globales/Boolean
/es/docs/Guía_JavaScript_1.5/Objetos_base_predefinidos/Objeto_Date	/es/docs/Web/JavaScript/Referencia/Objetos_globales/Date
/es/docs/Guía_JavaScript_1.5/Objetos_base_predefinidos/Objeto_Function	/es/docs/Web/JavaScript/Referencia/Objetos_globales/Function
/es/docs/Guía_JavaScript_1.5/Objetos_base_predefinidos/Objeto_Math	/es/docs/Web/JavaScript/Referencia/Objetos_globales/Math
/es/docs/Guía_JavaScript_1.5/Objetos_base_predefinidos/Objeto_Number	/es/docs/Web/JavaScript/Referencia/Objetos_globales/Number
/es/docs/Guía_JavaScript_1.5/Objetos_base_predefinidos/Objeto_RegExp	/es/docs/Web/JavaScript/Referencia/Objetos_globales/RegExp
/es/docs/Guía_JavaScript_1.5/Objetos_base_predefinidos/Objeto_String	/es/docs/Web/JavaScript/Referencia/Objetos_globales/String
/es/docs/Guía_JavaScript_1.5/Objetos_y_propiedades	/es/docs/Web/JavaScript/Guide/Trabajando_con_objectos#Objetos_y_propiedades
/es/docs/Guía_JavaScript_1.5/Operadores	/es/docs/Web/JavaScript/Guide/Expressions_and_Operators#Operadores
/es/docs/Guía_JavaScript_1.5/Operadores/Operadores_aritméticos	/es/docs/Web/JavaScript/Guide/Expressions_and_Operators#Operadores_aritm.C3.A9ticos
/es/docs/Guía_JavaScript_1.5/Operadores/Operadores_de_asignación	/es/docs/Web/JavaScript/Guide/Expressions_and_Operators#Operadores_de_asignaci.C3.B3n
/es/docs/Guía_JavaScript_1.5/Operadores/Operadores_de_cadenas_de_caracteres_(string)	/es/docs/Web/JavaScript/Guide/Expressions_and_Operators#String_operators
/es/docs/Guía_JavaScript_1.5/Operadores/Operadores_de_comparación	/es/docs/Web/JavaScript/Guide/Expressions_and_Operators#Operadores_de_comparaci.C3.B3n
/es/docs/Guía_JavaScript_1.5/Operadores/Operadores_especiales	/es/docs/Web/JavaScript/Guide/Expressions_and_Operators#Special_operators
/es/docs/Guía_JavaScript_1.5/Operadores/Operadores_lógicos	/es/docs/Web/JavaScript/Guide/Expressions_and_Operators#Operadores_l.C3.B3gicos
/es/docs/Guía_JavaScript_1.5/Operadores/Operadores_sobre_bits	/es/docs/Web/JavaScript/Guide/Expressions_and_Operators#Operadores_Bit-a-bit
/es/docs/Guía_JavaScript_1.5/Predefined_Functions	/es/docs/Web/JavaScript/Referencia/Objetos_globales
/es/docs/Guía_JavaScript_1.5/Predefined_Functions/eval_Function	/es/docs/Web/JavaScript/Referencia/Objetos_globales/eval
/es/docs/Guía_JavaScript_1.5/Sentencia_condicional	/es/docs/Web/JavaScript/Guide/Control_de_flujo_y_manejo_de_errores#Condicionales
/es/docs/Guía_JavaScript_1.5/Sentencia_de_bloque	/es/docs/Web/JavaScript/Referencia/Sentencias/block
/es/docs/Guía_JavaScript_1.5/Sentencias_de_bucle	/es/docs/Web/JavaScript/Guide/Loops_and_iteration
/es/docs/Guía_JavaScript_1.5/Sentencias_de_manejo_de_excepciones	/es/docs/Web/JavaScript/Guide/Control_de_flujo_y_manejo_de_errores#Utilizing_Error_objects
/es/docs/Guía_JavaScript_1.5/Sentencias_de_manejo_de_excepciones/throw	/es/docs/Web/JavaScript/Guide/Control_de_flujo_y_manejo_de_errores#throw_statement
/es/docs/Guía_JavaScript_1.5/Sentencias_de_manejo_de_excepciones/try...catch	/es/docs/Web/JavaScript/Guide/Control_de_flujo_y_manejo_de_errores#try...catch_statement
/es/docs/Guía_JavaScript_1.5/Sentencias_de_manipulación_de_objetos	/es/docs/Web/JavaScript/Guide
/es/docs/Guía_JavaScript_1.5/Sentencias_para_comentarios	/es/docs/Web/JavaScript/Guide
/es/docs/Guía_JavaScript_1.5/Trabajar_con_expresiones_regulares	/es/docs/Web/JavaScript/Guide/Regular_Expressions
/es/docs/Guía_JavaScript_1.5/Trabajar_con_expresiones_regulares/Ejecutar_una_busqueda_global,_discriminar_mayúsculas_y_minúsculas_y_considerar_entrada_multilínea	/es/docs/Web/JavaScript/Guide/Regular_Expressions
/es/docs/Guía_JavaScript_1.5/Trabajar_con_expresiones_regulares/Ejecutar_una_busqueda_global,_ignorar_mayusculas_minusculas,_y_considerar_entrada_multilinea	/es/docs/Guía_JavaScript_1.5/Trabajar_con_expresiones_regulares/Ejecutar_una_busqueda_global,_discriminar_mayusculas_y_minusculas_y_considerar_entrada_multilínea
/es/docs/Guía_JavaScript_1.5/Trabajar_con_expresiones_regulares/Ejemplos_de_expresiones_regulares	/es/docs/Web/JavaScript/Guide/Regular_Expressions
/es/docs/Guía_JavaScript_1.5/Trabajar_con_expresiones_regulares/Usar_coincidencias_de_subcadenas_parentizadas	/es/docs/Web/JavaScript/Guide/Regular_Expressions
/es/docs/Guía_JavaScript_1.5/Unicode	/en-US/docs/Web/JavaScript/Reference/Lexical_grammar
/es/docs/Guía_JavaScript_1.5/Usando_el_objeto_arguments	/es/docs/Web/JavaScript/Guide/Funciones
/es/docs/Guía_JavaScript_1.5/Using_the_arguments_object	/es/docs/Web/JavaScript/Guide/Funciones
/es/docs/Guía_JavaScript_1.5/Valores	/es/docs/Web/JavaScript/Guide/Grammar_and_types
/es/docs/Guía_JavaScript_1.5/Variables	/es/docs/Web/JavaScript/Guide/Grammar_and_types
/es/docs/Guía_JavaScript_1.5:Acerca_de_esta_guía	/es/docs/Web/JavaScript/Guide/Introducción
/es/docs/Guía_JavaScript_1.5:Características_generales_del_lenguaje	/es/docs/Guía_JavaScript_1.5/Características_generales_del_lenguaje
/es/docs/Guía_JavaScript_1.5:Concepto_General_de_LiveConnect:Conversiones_de_Tipo_de_Datos:Conversiones_de_Java_a_JavaScript	/es/docs/Guía_JavaScript_1.5/Concepto_General_de_LiveConnect/Conversiones_de_Tipo_de_Datos/Conversiones_de_Java_a_JavaScript
/es/docs/Guía_JavaScript_1.5:Concepto_de_JavaScript	/es/docs/Web/JavaScript/Guide/Introducción
/es/docs/Guía_JavaScript_1.5:Constantes	/es/docs/Web/JavaScript/Referencia/Sentencias/const
/es/docs/Guía_JavaScript_1.5:Crear_nuevos_objetos	/es/docs/Web/JavaScript/Guide/Trabajando_con_objectos#Creando_nuevos_objetos
/es/docs/Guía_JavaScript_1.5:Crear_nuevos_objetos:Borrando_propiedades	/es/docs/Web/JavaScript/Guide/Trabajando_con_objectos#Eliminando_propiedades
/es/docs/Guía_JavaScript_1.5:Crear_nuevos_objetos:Definiendo_las_funciones_get_y_set	/es/docs/Web/JavaScript/Guide/Trabajando_con_objectos#Definiendo_getters_y_setters
/es/docs/Guía_JavaScript_1.5:Crear_nuevos_objetos:Definiendo_los_métodos	/es/docs/Web/JavaScript/Guide/Trabajando_con_objectos#Definiendo_los_m.C3.A9todos
/es/docs/Guía_JavaScript_1.5:Crear_nuevos_objetos:Definiendo_propiedades_para_un_tipo_de_objeto	/es/docs/Web/JavaScript/Guide/Trabajando_con_objectos#Definici.C3.B3n_de_las_propiedades_de_un_tipo_de_objeto
/es/docs/Guía_JavaScript_1.5:Crear_nuevos_objetos:Indexando_las_propiedades_del_objeto	/es/docs/Web/JavaScript/Guide/Trabajando_con_objectos#Propiedades_del_objeto_indexado
/es/docs/Guía_JavaScript_1.5:Crear_nuevos_objetos:Usando_this_para_referirse_al_objeto	/es/docs/Web/JavaScript/Guide/Trabajando_con_objectos#Usando_this_para_las_referencias_a_objetos
/es/docs/Guía_JavaScript_1.5:Crear_nuevos_objetos:Usando_una_función_constructora	/es/docs/Web/JavaScript/Guide/Trabajando_con_objectos#Usando_una_funci.C3.B3n_constructora
/es/docs/Guía_JavaScript_1.5:Crear_nuevos_objetos:Using_Object_Initializers	/es/docs/Web/JavaScript/Guide/Trabajando_con_objectos#El_uso_de_inicializadores_de_objeto
/es/docs/Guía_JavaScript_1.5:Crear_nuevos_objetos:Utilizando_Objetos_Iniciadores	/es/docs/Web/JavaScript/Guide/Trabajando_con_objectos#El_uso_de_inicializadores_de_objeto
/es/docs/Guía_JavaScript_1.5:Crear_una_expresión_regular	/es/docs/Web/JavaScript/Guide/Regular_Expressions
/es/docs/Guía_JavaScript_1.5:Definiendo_Funciones	/es/docs/Web/JavaScript/Guide/Funciones
/es/docs/Guía_JavaScript_1.5:El_ejemplo_Empleado	/es/docs/Web/JavaScript/Guide/Details_of_the_Object_Model#Ejemplo.3A_employee
/es/docs/Guía_JavaScript_1.5:El_ejemplo_Employee	/es/docs/Web/JavaScript/Guide/Details_of_the_Object_Model#Ejemplo.3A_employee
/es/docs/Guía_JavaScript_1.5:El_ejemplo_Employee:Constructores_más_flexibles	/es/docs/Web/JavaScript/Guide/Details_of_the_Object_Model#Constructores_mas_flexibles
/es/docs/Guía_JavaScript_1.5:El_ejemplo_Employee:Creando_la_jerarquía	/es/docs/Web/JavaScript/Guide/Details_of_the_Object_Model#Creacion_de_la_jerarquia
/es/docs/Guía_JavaScript_1.5:El_ejemplo_Employee:Propiedades_de_objetos	/es/docs/Web/JavaScript/Guide/Details_of_the_Object_Model#Propiedades_de_objetos
/es/docs/Guía_JavaScript_1.5:El_ejemplo_Employee:Propiedades_de_objetos:Añadiendo_propiedades	/es/docs/Web/JavaScript/Guide/Details_of_the_Object_Model#A.C3.B1adir_propiedades
/es/docs/Guía_JavaScript_1.5:El_ejemplo_Employee:Propiedades_de_objetos:Heredando_las_propiedades	/es/docs/Web/JavaScript/Guide/Details_of_the_Object_Model#Herencia_de_propiedades
/es/docs/Guía_JavaScript_1.5:Escribir_un_patrón_de_expresión_regular	/es/docs/Web/JavaScript/Guide/Regular_Expressions
/es/docs/Guía_JavaScript_1.5:Expresiones	/es/docs/Web/JavaScript/Guide/Expressions_and_Operators
/es/docs/Guía_JavaScript_1.5:Expresiones_Regulares	/es/docs/Web/JavaScript/Guide/Regular_Expressions
/es/docs/Guía_JavaScript_1.5:Expresiones_y_operadores	/es/docs/Web/JavaScript/Guide/Expressions_and_Operators
/es/docs/Guía_JavaScript_1.5:Funciones_predefinidas	/es/docs/Web/JavaScript/Guide/Funciones#Predefined_functions
/es/docs/Guía_JavaScript_1.5:Funciones_predefinidas:Funciones_Number_y_String	/es/docs/Web/JavaScript/Guide/Funciones#Number_and_String_functions
/es/docs/Guía_JavaScript_1.5:Funciones_predefinidas:Funciones_escape_y_unescape	/es/docs/Web/JavaScript/Guide/Funciones#escape_and_unescape_functions(Obsoleted_above_JavaScript_1.5)
/es/docs/Guía_JavaScript_1.5:Funciones_predefinidas:Funciones_parseInt_y_parseFloat	/es/docs/Web/JavaScript/Guide/Funciones#parseInt_and_parseFloat_functions
/es/docs/Guía_JavaScript_1.5:Funciones_predefinidas:Función_eval	/es/docs/Web/JavaScript/Guide/Funciones#eval_Function
/es/docs/Guía_JavaScript_1.5:Funciones_predefinidas:Función_isFinite	/es/docs/Web/JavaScript/Guide/Funciones#isFinite_function
/es/docs/Guía_JavaScript_1.5:Funciones_predefinidas:Función_isNaN	/es/docs/Web/JavaScript/Guide/Funciones#isNaN_function
/es/docs/Guía_JavaScript_1.5:Lenguajes_basados_en_clases_frente_a_basados_en_prototipos	/es/docs/Web/JavaScript/Guide/Details_of_the_Object_Model
/es/docs/Guía_JavaScript_1.5:Literales	/es/docs/Web/JavaScript/Guide/Grammar_and_types#Literales
/es/docs/Guía_JavaScript_1.5:Llamando_Funciones	/es/docs/Web/JavaScript/Guide/Funciones#Llamando_funciones
/es/docs/Guía_JavaScript_1.5:Más_sobre_la_herencia_de_propiedades	/es/docs/Web/JavaScript/Guide/Details_of_the_Object_Model#Mas_sobre_herencia_de_propiedades
/es/docs/Guía_JavaScript_1.5:Más_sobre_la_herencia_de_propiedades:Determinando_relaciones_de_instancia	/es/docs/Web/JavaScript/Guide/Details_of_the_Object_Model#Como_determinar_las_relaciones_entre_instancias
/es/docs/Guía_JavaScript_1.5:Más_sobre_la_herencia_de_propiedades:Herencia_no_múltiple	/es/docs/Web/JavaScript/Guide/Details_of_the_Object_Model#No_existe_herencia_multiple
/es/docs/Guía_JavaScript_1.5:Más_sobre_la_herencia_de_propiedades:Información_global_en_los_constructores	/es/docs/Web/JavaScript/Guide/Details_of_the_Object_Model#Informacion_global_en_los_constructores
/es/docs/Guía_JavaScript_1.5:Más_sobre_la_herencia_de_propiedades:Valores_locales_frente_a_los_heredados	/es/docs/Web/JavaScript/Guide/Details_of_the_Object_Model#Valores_locales_frente_a_valores_heredados
/es/docs/Guía_JavaScript_1.5:Objetos_base_predefinidos	/es/docs/Web/JavaScript/Referencia
/es/docs/Guía_JavaScript_1.5:Objetos_base_predefinidos:Objeto_Array	/es/docs/Web/JavaScript/Referencia/Objetos_globales/Array
/es/docs/Guía_JavaScript_1.5:Objetos_base_predefinidos:Objeto_Boolean	/es/docs/Web/JavaScript/Referencia/Objetos_globales/Boolean
/es/docs/Guía_JavaScript_1.5:Objetos_base_predefinidos:Objeto_Date	/es/docs/Web/JavaScript/Referencia/Objetos_globales/Date
/es/docs/Guía_JavaScript_1.5:Objetos_base_predefinidos:Objeto_Function	/es/docs/Web/JavaScript/Referencia/Objetos_globales/Function
/es/docs/Guía_JavaScript_1.5:Objetos_base_predefinidos:Objeto_Math	/es/docs/Web/JavaScript/Referencia/Objetos_globales/Math
/es/docs/Guía_JavaScript_1.5:Objetos_base_predefinidos:Objeto_Number	/es/docs/Web/JavaScript/Referencia/Objetos_globales/Number
/es/docs/Guía_JavaScript_1.5:Objetos_base_predefinidos:Objeto_RegExp	/es/docs/Web/JavaScript/Referencia/Objetos_globales/RegExp
/es/docs/Guía_JavaScript_1.5:Objetos_base_predefinidos:Objeto_String	/es/docs/Web/JavaScript/Referencia/Objetos_globales/String
/es/docs/Guía_JavaScript_1.5:Objetos_y_propiedades	/es/docs/Web/JavaScript/Guide/Trabajando_con_objectos#Objetos_y_propiedades
/es/docs/Guía_JavaScript_1.5:Operadores	/es/docs/Web/JavaScript/Guide/Expressions_and_Operators#Operadores
/es/docs/Guía_JavaScript_1.5:Operadores:Operadores_aritméticos	/es/docs/Web/JavaScript/Guide/Expressions_and_Operators#Operadores_aritm.C3.A9ticos
/es/docs/Guía_JavaScript_1.5:Operadores:Operadores_de_asignación	/es/docs/Web/JavaScript/Guide/Expressions_and_Operators#Operadores_de_asignaci.C3.B3n
/es/docs/Guía_JavaScript_1.5:Operadores:Operadores_de_cadena_de_caracteres_(string)	/es/docs/Guía_JavaScript_1.5/Operadores/Operadores_de_cadena_de_caracteres_(string)
/es/docs/Guía_JavaScript_1.5:Operadores:Operadores_de_cadenas_de_caracteres_(string)	/es/docs/Web/JavaScript/Guide/Expressions_and_Operators#String_operators
/es/docs/Guía_JavaScript_1.5:Operadores:Operadores_de_comparación	/es/docs/Web/JavaScript/Guide/Expressions_and_Operators#Operadores_de_comparaci.C3.B3n
/es/docs/Guía_JavaScript_1.5:Operadores:Operadores_especiales	/es/docs/Web/JavaScript/Guide/Expressions_and_Operators#Special_operators
/es/docs/Guía_JavaScript_1.5:Operadores:Operadores_lógicos	/es/docs/Web/JavaScript/Guide/Expressions_and_Operators#Operadores_l.C3.B3gicos
/es/docs/Guía_JavaScript_1.5:Operadores:Operadores_sobre_bits	/es/docs/Web/JavaScript/Guide/Expressions_and_Operators#Operadores_Bit-a-bit
/es/docs/Guía_JavaScript_1.5:Predefined_Functions:eval_Function	/es/docs/Web/JavaScript/Referencia/Objetos_globales/eval
/es/docs/Guía_JavaScript_1.5:Sentencia_condicional	/es/docs/Web/JavaScript/Guide/Control_de_flujo_y_manejo_de_errores#Condicionales
/es/docs/Guía_JavaScript_1.5:Sentencia_de_bloque	/es/docs/Web/JavaScript/Referencia/Sentencias/block
/es/docs/Guía_JavaScript_1.5:Sentencias_de_bucle	/es/docs/Web/JavaScript/Guide/Loops_and_iteration
/es/docs/Guía_JavaScript_1.5:Sentencias_de_manejo_de_excepciones	/es/docs/Web/JavaScript/Guide/Control_de_flujo_y_manejo_de_errores#Utilizing_Error_objects
/es/docs/Guía_JavaScript_1.5:Sentencias_de_manejo_de_excepciones:throw	/es/docs/Web/JavaScript/Guide/Control_de_flujo_y_manejo_de_errores#throw_statement
/es/docs/Guía_JavaScript_1.5:Sentencias_de_manejo_de_excepciones:try...catch	/es/docs/Web/JavaScript/Guide/Control_de_flujo_y_manejo_de_errores#try...catch_statement
/es/docs/Guía_JavaScript_1.5:Sentencias_de_manipulación_de_objetos	/es/docs/Web/JavaScript/Guide
/es/docs/Guía_JavaScript_1.5:Sentencias_para_comentarios	/es/docs/Web/JavaScript/Guide
/es/docs/Guía_JavaScript_1.5:Trabajar_con_expresiones_regulares	/es/docs/Web/JavaScript/Guide/Regular_Expressions
/es/docs/Guía_JavaScript_1.5:Trabajar_con_expresiones_regulares:Ejecutar_una_busqueda_global,_discriminar_mayúsculas_y_minúsculas_y_considerar_entrada_multilínea	/es/docs/Web/JavaScript/Guide/Regular_Expressions
/es/docs/Guía_JavaScript_1.5:Trabajar_con_expresiones_regulares:Ejecutar_una_busqueda_global,_ignorar_mayusculas_minusculas,_y_considerar_entrada_multilinea	/es/docs/Guía_JavaScript_1.5/Trabajar_con_expresiones_regulares/Ejecutar_una_busqueda_global,_discriminar_mayusculas_y_minusculas_y_considerar_entrada_multilínea
/es/docs/Guía_JavaScript_1.5:Trabajar_con_expresiones_regulares:Ejemplos_de_expresiones_regulares	/es/docs/Web/JavaScript/Guide/Regular_Expressions
/es/docs/Guía_JavaScript_1.5:Trabajar_con_expresiones_regulares:Usar_coincidencias_de_subcadenas_parentizadas	/es/docs/Web/JavaScript/Guide/Regular_Expressions
/es/docs/Guía_JavaScript_1.5:Unicode	/en-US/docs/Web/JavaScript/Reference/Lexical_grammar
/es/docs/Guía_JavaScript_1.5:Usando_el_objeto_arguments	/es/docs/Web/JavaScript/Guide/Funciones
/es/docs/Guía_JavaScript_1.5:Using_the_arguments_object	/es/docs/Web/JavaScript/Guide/Funciones
/es/docs/Guía_JavaScript_1.5:Valores	/es/docs/Web/JavaScript/Guide/Grammar_and_types
/es/docs/Guía_JavaScript_1.5:Variables	/es/docs/Web/JavaScript/Guide/Grammar_and_types
/es/docs/Guía_de_referencia_de_CSS	/es/docs/Web/CSS/Referencia_CSS
/es/docs/HTML	/es/docs/Web/HTML
/es/docs/HTML/Block-level_elements	/es/docs/Web/HTML/Block-level_elements
/es/docs/HTML/Canvas	/es/docs/Web/HTML/Canvas
/es/docs/HTML/Canvas/Drawing_DOM_objects_into_a_canvas	/es/docs/Web/HTML/Canvas/Drawing_DOM_objects_into_a_canvas
/es/docs/HTML/Canvas/Drawing_graphics_with_canvas	/es/docs/Web/HTML/Canvas/Drawing_graphics_with_canvas
/es/docs/HTML/Consejos_para_la_creación_de_páginas_HTML_de_carga_rápida	/es/docs/Web/HTML/Consejos_para_la_creación_de_páginas_HTML_de_carga_rápida
/es/docs/HTML/Element	/es/docs/Web/HTML/Elemento
/es/docs/HTML/Element/a	/es/docs/Web/HTML/Elemento/a
/es/docs/HTML/Element/form	/es/docs/Web/HTML/Elemento/form
/es/docs/HTML/Element/hgroup	/es/docs/Web/HTML/Elemento/hgroup
/es/docs/HTML/Element/iframe	/es/docs/Web/HTML/Elemento/iframe
/es/docs/HTML/Element/section	/es/docs/Web/HTML/Elemento/section
/es/docs/HTML/Element/tabla	/es/docs/Web/HTML/Elemento/table
/es/docs/HTML/Element/table	/es/docs/Web/HTML/Elemento/table
/es/docs/HTML/Element/video	/es/docs/Web/HTML/Elemento/video
/es/docs/HTML/Elemento	/es/docs/Web/HTML/Elemento
/es/docs/HTML/Elemento/<html>	/es/docs/Web/HTML/Elemento/<html>
/es/docs/HTML/Elemento/Audio	/es/docs/Web/HTML/Elemento/Audio
/es/docs/HTML/Elemento/Elementos_títulos	/es/docs/Web/HTML/Elemento/Elementos_títulos
/es/docs/HTML/Elemento/Progreso	/es/docs/Web/HTML/Elemento/progress
/es/docs/HTML/Elemento/Tipos_de_elementos	/es/docs/Web/HTML/Elemento/Tipos_de_elementos
/es/docs/HTML/Elemento/a	/es/docs/Web/HTML/Elemento/a
/es/docs/HTML/Elemento/abbr	/es/docs/Web/HTML/Elemento/abbr
/es/docs/HTML/Elemento/acronym	/es/docs/Web/HTML/Elemento/acronym
/es/docs/HTML/Elemento/address	/es/docs/Web/HTML/Elemento/address
/es/docs/HTML/Elemento/applet	/es/docs/Web/HTML/Elemento/applet
/es/docs/HTML/Elemento/area	/es/docs/Web/HTML/Elemento/area
/es/docs/HTML/Elemento/article	/es/docs/Web/HTML/Elemento/article
/es/docs/HTML/Elemento/aside	/es/docs/Web/HTML/Elemento/aside
/es/docs/HTML/Elemento/b	/es/docs/Web/HTML/Elemento/b
/es/docs/HTML/Elemento/base	/es/docs/Web/HTML/Elemento/base
/es/docs/HTML/Elemento/basefont	/es/docs/Web/HTML/Elemento/basefont
/es/docs/HTML/Elemento/bdo	/es/docs/Web/HTML/Elemento/bdo
/es/docs/HTML/Elemento/big	/es/docs/Web/HTML/Elemento/big
/es/docs/HTML/Elemento/blockquote	/es/docs/Web/HTML/Elemento/blockquote
/es/docs/HTML/Elemento/body	/es/docs/Web/HTML/Elemento/body
/es/docs/HTML/Elemento/br	/es/docs/Web/HTML/Elemento/br
/es/docs/HTML/Elemento/button	/es/docs/Web/HTML/Elemento/button
/es/docs/HTML/Elemento/canvas	/es/docs/Web/HTML/Elemento/canvas
/es/docs/HTML/Elemento/caption	/es/docs/Web/HTML/Elemento/caption
/es/docs/HTML/Elemento/center	/es/docs/Web/HTML/Elemento/center
/es/docs/HTML/Elemento/cite	/es/docs/Web/HTML/Elemento/cite
/es/docs/HTML/Elemento/code	/es/docs/Web/HTML/Elemento/code
/es/docs/HTML/Elemento/col	/es/docs/Web/HTML/Elemento/col
/es/docs/HTML/Elemento/colgroup	/es/docs/Web/HTML/Elemento/colgroup
/es/docs/HTML/Elemento/dd	/es/docs/Web/HTML/Elemento/dd
/es/docs/HTML/Elemento/del	/es/docs/Web/HTML/Elemento/del
/es/docs/HTML/Elemento/dfn	/es/docs/Web/HTML/Elemento/dfn
/es/docs/HTML/Elemento/dir	/es/docs/Web/HTML/Elemento/dir
/es/docs/HTML/Elemento/div	/es/docs/Web/HTML/Elemento/div
/es/docs/HTML/Elemento/dl	/es/docs/Web/HTML/Elemento/dl
/es/docs/HTML/Elemento/dt	/es/docs/Web/HTML/Elemento/dt
/es/docs/HTML/Elemento/em	/es/docs/Web/HTML/Elemento/em
/es/docs/HTML/Elemento/embed	/es/docs/Web/HTML/Elemento/embed
/es/docs/HTML/Elemento/etiqueta	/es/docs/Web/HTML/Elemento/label
/es/docs/HTML/Elemento/fieldset	/es/docs/Web/HTML/Elemento/fieldset
/es/docs/HTML/Elemento/figure	/es/docs/Web/HTML/Elemento/figure
/es/docs/HTML/Elemento/font	/es/docs/Web/HTML/Elemento/font
/es/docs/HTML/Elemento/footer	/es/docs/Web/HTML/Elemento/footer
/es/docs/HTML/Elemento/frame	/es/docs/Web/HTML/Elemento/frame
/es/docs/HTML/Elemento/frameset	/es/docs/Web/HTML/Elemento/frameset
/es/docs/HTML/Elemento/h1	/es/docs/Web/HTML/Elemento/Elementos_títulos
/es/docs/HTML/Elemento/h2	/es/docs/Web/HTML/Elemento/Elementos_títulos
/es/docs/HTML/Elemento/h3	/es/docs/Web/HTML/Elemento/Elementos_títulos
/es/docs/HTML/Elemento/h4	/es/docs/Web/HTML/Elemento/Elementos_títulos
/es/docs/HTML/Elemento/h5	/es/docs/Web/HTML/Elemento/Elementos_títulos
/es/docs/HTML/Elemento/h6	/es/docs/Web/HTML/Elemento/Elementos_títulos
/es/docs/HTML/Elemento/head	/es/docs/Web/HTML/Elemento/head
/es/docs/HTML/Elemento/header	/es/docs/Web/HTML/Elemento/header
/es/docs/HTML/Elemento/hr	/es/docs/Web/HTML/Elemento/hr
/es/docs/HTML/Elemento/html	/es/docs/Web/HTML/Elemento/html
/es/docs/HTML/Elemento/i	/es/docs/Web/HTML/Elemento/i
/es/docs/HTML/Elemento/img	/es/docs/Web/HTML/Elemento/img
/es/docs/HTML/Elemento/input	/es/docs/Web/HTML/Elemento/input
/es/docs/HTML/Elemento/ins	/es/docs/Web/HTML/Elemento/ins
/es/docs/HTML/Elemento/kbd	/es/docs/Web/HTML/Elemento/kbd
/es/docs/HTML/Elemento/keygen	/es/docs/Web/HTML/Elemento/keygen
/es/docs/HTML/Elemento/label	/es/docs/Web/HTML/Elemento/label
/es/docs/HTML/Elemento/legend	/es/docs/Web/HTML/Elemento/legend
/es/docs/HTML/Elemento/li	/es/docs/Web/HTML/Elemento/li
/es/docs/HTML/Elemento/link	/es/docs/Web/HTML/Elemento/link
/es/docs/HTML/Elemento/main	/es/docs/Web/HTML/Elemento/main
/es/docs/HTML/Elemento/map	/es/docs/Web/HTML/Elemento/map
/es/docs/HTML/Elemento/mark	/es/docs/Web/HTML/Elemento/mark
/es/docs/HTML/Elemento/menu	/es/docs/Web/HTML/Elemento/menu
/es/docs/HTML/Elemento/meta	/es/docs/Web/HTML/Elemento/meta
/es/docs/HTML/Elemento/nav	/es/docs/Web/HTML/Elemento/nav
/es/docs/HTML/Elemento/noframes	/es/docs/Web/HTML/Elemento/noframes
/es/docs/HTML/Elemento/noscript	/es/docs/Web/HTML/Elemento/noscript
/es/docs/HTML/Elemento/ol	/es/docs/Web/HTML/Elemento/ol
/es/docs/HTML/Elemento/p	/es/docs/Web/HTML/Elemento/p
/es/docs/HTML/Elemento/param	/es/docs/Web/HTML/Elemento/param
/es/docs/HTML/Elemento/pre	/es/docs/Web/HTML/Elemento/pre
/es/docs/HTML/Elemento/preformato	/es/docs/Web/HTML/Elemento/pre
/es/docs/HTML/Elemento/q	/es/docs/Web/HTML/Elemento/q
/es/docs/HTML/Elemento/s	/es/docs/Web/HTML/Elemento/s
/es/docs/HTML/Elemento/samp	/es/docs/Web/HTML/Elemento/samp
/es/docs/HTML/Elemento/small	/es/docs/Web/HTML/Elemento/small
/es/docs/HTML/Elemento/source	/es/docs/Web/HTML/Elemento/source
/es/docs/HTML/Elemento/span	/es/docs/Web/HTML/Elemento/span
/es/docs/HTML/Elemento/strike	/es/docs/Web/HTML/Elemento/strike
/es/docs/HTML/Elemento/strong	/es/docs/Web/HTML/Elemento/strong
/es/docs/HTML/Elemento/style	/es/docs/Web/HTML/Elemento/style
/es/docs/HTML/Elemento/sub	/es/docs/Web/HTML/Elemento/sub
/es/docs/HTML/Elemento/sup	/es/docs/Web/HTML/Elemento/sup
/es/docs/HTML/Elemento/time	/es/docs/Web/HTML/Elemento/time
/es/docs/HTML/Elemento/title	/es/docs/Web/HTML/Elemento/title
/es/docs/HTML/Elemento/tt	/es/docs/Web/HTML/Elemento/tt
/es/docs/HTML/Elemento/u	/es/docs/Web/HTML/Elemento/u
/es/docs/HTML/Elemento/ul	/es/docs/Web/HTML/Elemento/ul
/es/docs/HTML/Elemento/var	/es/docs/Web/HTML/Elemento/var
/es/docs/HTML/Elemento/video	/es/docs/Web/HTML/Elemento/video
/es/docs/HTML/Formatos_admitidos_de_audio_y_video_en_html5	/es/docs/Web/HTML/Formatos_admitidos_de_audio_y_video_en_html5
/es/docs/HTML/HTML5/Introduction_to_HTML5	/es/docs/HTML/HTML5/Introducción_a_HTML5
/es/docs/HTML/La_importancia_de_comentar_correctamente	/es/docs/Web/HTML/La_importancia_de_comentar_correctamente
/es/docs/HTML:Canvas	/es/docs/Web/HTML/Canvas
/es/docs/HTML:Comunidad	/es/docs/HTML/Comunidad
/es/docs/HTML:Element	/es/docs/Web/HTML/Elemento
/es/docs/HTML:Element:a	/es/docs/Web/HTML/Elemento/a
/es/docs/HTML:Elemento	/es/docs/Web/HTML/Elemento
/es/docs/HTML:Elemento:Tipos_de_elementos	/es/docs/Web/HTML/Elemento/Tipos_de_elementos
/es/docs/HTML:Elemento:a	/es/docs/Web/HTML/Elemento/a
/es/docs/HTML:Elemento:abbr	/es/docs/Web/HTML/Elemento/abbr
/es/docs/HTML:Elemento:acronym	/es/docs/Web/HTML/Elemento/acronym
/es/docs/HTML:Elemento:address	/es/docs/Web/HTML/Elemento/address
/es/docs/HTML:Elemento:applet	/es/docs/Web/HTML/Elemento/applet
/es/docs/HTML:Elemento:area	/es/docs/Web/HTML/Elemento/area
/es/docs/HTML:Elemento:b	/es/docs/Web/HTML/Elemento/b
/es/docs/HTML:Elemento:base	/es/docs/Web/HTML/Elemento/base
/es/docs/HTML:Elemento:basefont	/es/docs/Web/HTML/Elemento/basefont
/es/docs/HTML:Elemento:bdo	/es/docs/Web/HTML/Elemento/bdo
/es/docs/HTML:Elemento:big	/es/docs/Web/HTML/Elemento/big
/es/docs/HTML:Elemento:blockquote	/es/docs/Web/HTML/Elemento/blockquote
/es/docs/HTML:Elemento:body	/es/docs/Web/HTML/Elemento/body
/es/docs/HTML:Elemento:br	/es/docs/Web/HTML/Elemento/br
/es/docs/HTML:Elemento:button	/es/docs/Web/HTML/Elemento/button
/es/docs/HTML:Elemento:caption	/es/docs/Web/HTML/Elemento/caption
/es/docs/HTML:Elemento:center	/es/docs/Web/HTML/Elemento/center
/es/docs/HTML:Elemento:cite	/es/docs/Web/HTML/Elemento/cite
/es/docs/HTML:Elemento:code	/es/docs/Web/HTML/Elemento/code
/es/docs/HTML:Elemento:col	/es/docs/Web/HTML/Elemento/col
/es/docs/HTML:Elemento:colgroup	/es/docs/Web/HTML/Elemento/colgroup
/es/docs/HTML:Elemento:dd	/es/docs/Web/HTML/Elemento/dd
/es/docs/HTML:Elemento:del	/es/docs/Web/HTML/Elemento/del
/es/docs/HTML:Elemento:dfn	/es/docs/Web/HTML/Elemento/dfn
/es/docs/HTML:Elemento:dir	/es/docs/Web/HTML/Elemento/dir
/es/docs/HTML:Elemento:div	/es/docs/Web/HTML/Elemento/div
/es/docs/HTML:Elemento:dl	/es/docs/Web/HTML/Elemento/dl
/es/docs/HTML:Elemento:dt	/es/docs/Web/HTML/Elemento/dt
/es/docs/HTML:Elemento:em	/es/docs/Web/HTML/Elemento/em
/es/docs/HTML:Elemento:fieldset	/es/docs/Web/HTML/Elemento/fieldset
/es/docs/HTML:Elemento:font	/es/docs/Web/HTML/Elemento/font
/es/docs/HTML:Elemento:frame	/es/docs/Web/HTML/Elemento/frame
/es/docs/HTML:Elemento:frameset	/es/docs/Web/HTML/Elemento/frameset
/es/docs/HTML:Elemento:h1	/es/docs/Web/HTML/Elemento/Elementos_títulos
/es/docs/HTML:Elemento:h2	/es/docs/Web/HTML/Elemento/Elementos_títulos
/es/docs/HTML:Elemento:h3	/es/docs/Web/HTML/Elemento/Elementos_títulos
/es/docs/HTML:Elemento:h4	/es/docs/Web/HTML/Elemento/Elementos_títulos
/es/docs/HTML:Elemento:h5	/es/docs/Web/HTML/Elemento/Elementos_títulos
/es/docs/HTML:Elemento:h6	/es/docs/Web/HTML/Elemento/Elementos_títulos
/es/docs/HTML:Elemento:head	/es/docs/Web/HTML/Elemento/head
/es/docs/HTML:Elemento:hr	/es/docs/Web/HTML/Elemento/hr
/es/docs/HTML:Elemento:html	/es/docs/Web/HTML/Elemento/html
/es/docs/HTML:Elemento:i	/es/docs/Web/HTML/Elemento/i
/es/docs/HTML:Elemento:ins	/es/docs/Web/HTML/Elemento/ins
/es/docs/HTML:Elemento:kbd	/es/docs/Web/HTML/Elemento/kbd
/es/docs/HTML:Elemento:label	/es/docs/Web/HTML/Elemento/label
/es/docs/HTML:Elemento:legend	/es/docs/Web/HTML/Elemento/legend
/es/docs/HTML:Elemento:li	/es/docs/Web/HTML/Elemento/li
/es/docs/HTML:Elemento:link	/es/docs/Web/HTML/Elemento/link
/es/docs/HTML:Elemento:map	/es/docs/Web/HTML/Elemento/map
/es/docs/HTML:Elemento:menu	/es/docs/Web/HTML/Elemento/menu
/es/docs/HTML:Elemento:meta	/es/docs/Web/HTML/Elemento/meta
/es/docs/HTML:Elemento:noframes	/es/docs/Web/HTML/Elemento/noframes
/es/docs/HTML:Elemento:noscript	/es/docs/Web/HTML/Elemento/noscript
/es/docs/HTML:Elemento:ol	/es/docs/Web/HTML/Elemento/ol
/es/docs/HTML:Elemento:p	/es/docs/Web/HTML/Elemento/p
/es/docs/HTML:Elemento:param	/es/docs/Web/HTML/Elemento/param
/es/docs/HTML:Elemento:pre	/es/docs/Web/HTML/Elemento/pre
/es/docs/HTML:Elemento:q	/es/docs/Web/HTML/Elemento/q
/es/docs/HTML:Elemento:s	/es/docs/Web/HTML/Elemento/s
/es/docs/HTML:Elemento:samp	/es/docs/Web/HTML/Elemento/samp
/es/docs/HTML:Elemento:small	/es/docs/Web/HTML/Elemento/small
/es/docs/HTML:Elemento:span	/es/docs/Web/HTML/Elemento/span
/es/docs/HTML:Elemento:strike	/es/docs/Web/HTML/Elemento/strike
/es/docs/HTML:Elemento:strong	/es/docs/Web/HTML/Elemento/strong
/es/docs/HTML:Elemento:style	/es/docs/Web/HTML/Elemento/style
/es/docs/HTML:Elemento:sub	/es/docs/Web/HTML/Elemento/sub
/es/docs/HTML:Elemento:sup	/es/docs/Web/HTML/Elemento/sup
/es/docs/HTML:Elemento:title	/es/docs/Web/HTML/Elemento/title
/es/docs/HTML:Elemento:tt	/es/docs/Web/HTML/Elemento/tt
/es/docs/HTML:Elemento:u	/es/docs/Web/HTML/Elemento/u
/es/docs/HTML:Elemento:ul	/es/docs/Web/HTML/Elemento/ul
/es/docs/HTML:Elemento:var	/es/docs/Web/HTML/Elemento/var
/es/docs/HTML:La_importancia_de_comentar_correctamente	/es/docs/Web/HTML/La_importancia_de_comentar_correctamente
/es/docs/Herramientas_API	/es/docs/API_del_Toolkit
/es/docs/Html_Validator_(externo)	https://addons.mozilla.org/firefox/249/
/es/docs/IndexedDB-840092-dup	/es/docs/Web/API/IndexedDB_API
/es/docs/IndexedDB-840092-dup/Conceptos_Basicos_Detras_De_IndexedDB	/es/docs/Web/API/IndexedDB_API/Conceptos_Basicos_Detras_De_IndexedDB
/es/docs/IndexedDB-840092-dup/Usando_IndexedDB	/es/docs/Web/API/IndexedDB_API/Usando_IndexedDB
/es/docs/Instalar_el_manifest	/es/docs/Manifiesto_de_instalación
/es/docs/Install_Manifests	/es/docs/Manifiesto_de_instalación
/es/docs/Introducción_a_JavaScript_orientado_a_objetos	/es/docs/Web/JavaScript/Introducción_a_JavaScript_orientado_a_objetos
/es/docs/Introducción_a_XML	/es/docs/Web/XML/Introducción_a_XML
/es/docs/Introduction	/es/docs/Mozilla/Developer_guide/Introduction
/es/docs/Introduction_to_using_XPath_in_JavaScript	/es/docs/Web/JavaScript/Introduction_to_using_XPath_in_JavaScript
/es/docs/JavaScript	/es/docs/Web/JavaScript
/es/docs/JavaScript/Acerca_de_JavaScript	/es/docs/Web/JavaScript/Acerca_de_JavaScript
/es/docs/JavaScript/Guide	/es/docs/Web/JavaScript/Guide
/es/docs/JavaScript/Guide/AcercaDe	/es/docs/Web/JavaScript/Guide/Introducción
/es/docs/JavaScript/Guide/Closures	/es/docs/Web/JavaScript/Closures
/es/docs/JavaScript/Guide/Details_of_the_Object_Model	/es/docs/Web/JavaScript/Guide/Details_of_the_Object_Model
/es/docs/JavaScript/Guide/Funciones	/es/docs/Web/JavaScript/Guide/Funciones
/es/docs/JavaScript/Guide/Inheritance_Revisited	/es/docs/Web/JavaScript/Inheritance_and_the_prototype_chain
/es/docs/JavaScript/Guide/JavaScript_Overview	/es/docs/Web/JavaScript/Guide/Introducción
/es/docs/JavaScript/Guide/Obsolete_Pages	/es/docs/Web/JavaScript/Guide
/es/docs/JavaScript/Guide/Obsolete_Pages/Guía_JavaScript_1.5	/es/docs/Web/JavaScript/Guide
/es/docs/JavaScript/Guide/Obsolete_Pages/Guía_JavaScript_1.5/Acerca_de_esta_guía	/es/docs/Web/JavaScript/Guide/Introducción
/es/docs/JavaScript/Guide/Obsolete_Pages/Guía_JavaScript_1.5/Concepto_de_JavaScript	/es/docs/Web/JavaScript/Guide/Introducción
/es/docs/JavaScript/Guide/Obsolete_Pages/Guía_JavaScript_1.5/Constantes	/es/docs/Web/JavaScript/Referencia/Sentencias/const
/es/docs/JavaScript/Guide/Obsolete_Pages/Guía_JavaScript_1.5/Constructores_más_flexibles	/es/docs/Web/JavaScript/Guide/Details_of_the_Object_Model#Constructores_mas_flexibles
/es/docs/JavaScript/Guide/Obsolete_Pages/Guía_JavaScript_1.5/Crear_nuevos_objetos	/es/docs/Web/JavaScript/Guide/Trabajando_con_objectos#Creando_nuevos_objetos
/es/docs/JavaScript/Guide/Obsolete_Pages/Guía_JavaScript_1.5/Crear_nuevos_objetos/Borrando_propiedades	/es/docs/Web/JavaScript/Guide/Trabajando_con_objectos#Eliminando_propiedades
/es/docs/JavaScript/Guide/Obsolete_Pages/Guía_JavaScript_1.5/Crear_nuevos_objetos/Definiendo_las_funciones_get_y_set	/es/docs/Web/JavaScript/Guide/Trabajando_con_objectos#Definiendo_getters_y_setters
/es/docs/JavaScript/Guide/Obsolete_Pages/Guía_JavaScript_1.5/Crear_nuevos_objetos/Definiendo_los_métodos	/es/docs/Web/JavaScript/Guide/Trabajando_con_objectos#Definiendo_los_m.C3.A9todos
/es/docs/JavaScript/Guide/Obsolete_Pages/Guía_JavaScript_1.5/Crear_nuevos_objetos/Definiendo_propiedades_para_un_tipo_de_objeto	/es/docs/Web/JavaScript/Guide/Trabajando_con_objectos#Definici.C3.B3n_de_las_propiedades_de_un_tipo_de_objeto
/es/docs/JavaScript/Guide/Obsolete_Pages/Guía_JavaScript_1.5/Crear_nuevos_objetos/Indexando_las_propiedades_del_objeto	/es/docs/Web/JavaScript/Guide/Trabajando_con_objectos#Propiedades_del_objeto_indexado
/es/docs/JavaScript/Guide/Obsolete_Pages/Guía_JavaScript_1.5/Crear_nuevos_objetos/Usando_this_para_referirse_al_objeto	/es/docs/Web/JavaScript/Guide/Trabajando_con_objectos#Usando_this_para_las_referencias_a_objetos
/es/docs/JavaScript/Guide/Obsolete_Pages/Guía_JavaScript_1.5/Crear_nuevos_objetos/Usando_una_función_constructora	/es/docs/Web/JavaScript/Guide/Trabajando_con_objectos#Usando_una_funci.C3.B3n_constructora
/es/docs/JavaScript/Guide/Obsolete_Pages/Guía_JavaScript_1.5/Crear_nuevos_objetos/Using_Object_Initializers	/es/docs/Web/JavaScript/Guide/Trabajando_con_objectos#El_uso_de_inicializadores_de_objeto
/es/docs/JavaScript/Guide/Obsolete_Pages/Guía_JavaScript_1.5/Crear_nuevos_objetos/Utilizando_Objetos_Iniciadores	/es/docs/Web/JavaScript/Guide/Trabajando_con_objectos#El_uso_de_inicializadores_de_objeto
/es/docs/JavaScript/Guide/Obsolete_Pages/Guía_JavaScript_1.5/Crear_una_expresión_regular	/es/docs/Web/JavaScript/Guide/Regular_Expressions
/es/docs/JavaScript/Guide/Obsolete_Pages/Guía_JavaScript_1.5/Definiendo_Funciones	/es/docs/Web/JavaScript/Guide/Funciones
/es/docs/JavaScript/Guide/Obsolete_Pages/Guía_JavaScript_1.5/El_ejemplo_Empleado	/es/docs/Web/JavaScript/Guide/Details_of_the_Object_Model#Ejemplo.3A_employee
/es/docs/JavaScript/Guide/Obsolete_Pages/Guía_JavaScript_1.5/El_ejemplo_Employee	/es/docs/Web/JavaScript/Guide/Details_of_the_Object_Model#Ejemplo.3A_employee
/es/docs/JavaScript/Guide/Obsolete_Pages/Guía_JavaScript_1.5/El_ejemplo_Employee/Creando_la_jerarquía	/es/docs/Web/JavaScript/Guide/Details_of_the_Object_Model#Creacion_de_la_jerarquia
/es/docs/JavaScript/Guide/Obsolete_Pages/Guía_JavaScript_1.5/El_ejemplo_Employee/Propiedades_de_objetos	/es/docs/Web/JavaScript/Guide/Details_of_the_Object_Model#Propiedades_de_objetos
/es/docs/JavaScript/Guide/Obsolete_Pages/Guía_JavaScript_1.5/El_ejemplo_Employee/Propiedades_de_objetos/Añadiendo_propiedades	/es/docs/Web/JavaScript/Guide/Details_of_the_Object_Model#A.C3.B1adir_propiedades
/es/docs/JavaScript/Guide/Obsolete_Pages/Guía_JavaScript_1.5/El_ejemplo_Employee/Propiedades_de_objetos/Heredando_las_propiedades	/es/docs/Web/JavaScript/Guide/Details_of_the_Object_Model#Herencia_de_propiedades
/es/docs/JavaScript/Guide/Obsolete_Pages/Guía_JavaScript_1.5/Escribir_un_patrón_de_expresión_regular	/es/docs/Web/JavaScript/Guide/Regular_Expressions
/es/docs/JavaScript/Guide/Obsolete_Pages/Guía_JavaScript_1.5/Excepción_del_DOM	/es/docs/Web/API/DOMException
/es/docs/JavaScript/Guide/Obsolete_Pages/Guía_JavaScript_1.5/Expresiones	/es/docs/Web/JavaScript/Guide/Expressions_and_Operators
/es/docs/JavaScript/Guide/Obsolete_Pages/Guía_JavaScript_1.5/Expresiones_Regulares	/es/docs/Web/JavaScript/Guide/Regular_Expressions
/es/docs/JavaScript/Guide/Obsolete_Pages/Guía_JavaScript_1.5/Expresiones_y_operadores	/es/docs/Web/JavaScript/Guide/Expressions_and_Operators
/es/docs/JavaScript/Guide/Obsolete_Pages/Guía_JavaScript_1.5/Funciones_Number_y_String	/es/docs/Web/JavaScript/Guide/Funciones#Number_and_String_functions
/es/docs/JavaScript/Guide/Obsolete_Pages/Guía_JavaScript_1.5/Funciones_escape_y_unescape	/es/docs/Web/JavaScript/Guide/Funciones#escape_and_unescape_functions(Obsoleted_above_JavaScript_1.5)
/es/docs/JavaScript/Guide/Obsolete_Pages/Guía_JavaScript_1.5/Funciones_parseInt_y_parseFloat	/es/docs/Web/JavaScript/Guide/Funciones#parseInt_and_parseFloat_functions
/es/docs/JavaScript/Guide/Obsolete_Pages/Guía_JavaScript_1.5/Funciones_predefinidas	/es/docs/Web/JavaScript/Guide/Funciones#Predefined_functions
/es/docs/JavaScript/Guide/Obsolete_Pages/Guía_JavaScript_1.5/Funciones_predefinidas/Función_eval	/es/docs/Web/JavaScript/Guide/Funciones#eval_Function
/es/docs/JavaScript/Guide/Obsolete_Pages/Guía_JavaScript_1.5/Funciones_predefinidas/Función_isFinite	/es/docs/Web/JavaScript/Guide/Funciones#isFinite_function
/es/docs/JavaScript/Guide/Obsolete_Pages/Guía_JavaScript_1.5/Funciones_predefinidas/Función_isNaN	/es/docs/Web/JavaScript/Guide/Funciones#isNaN_function
/es/docs/JavaScript/Guide/Obsolete_Pages/Guía_JavaScript_1.5/Lenguajes_basados_en_clases_frente_a_basados_en_prototipos	/es/docs/Web/JavaScript/Guide/Details_of_the_Object_Model
/es/docs/JavaScript/Guide/Obsolete_Pages/Guía_JavaScript_1.5/Literales	/es/docs/Web/JavaScript/Guide/Grammar_and_types#Literales
/es/docs/JavaScript/Guide/Obsolete_Pages/Guía_JavaScript_1.5/Llamando_Funciones	/es/docs/Web/JavaScript/Guide/Funciones#Llamando_funciones
/es/docs/JavaScript/Guide/Obsolete_Pages/Guía_JavaScript_1.5/Más_sobre_la_herencia_de_propiedades	/es/docs/Web/JavaScript/Guide/Details_of_the_Object_Model#Mas_sobre_herencia_de_propiedades
/es/docs/JavaScript/Guide/Obsolete_Pages/Guía_JavaScript_1.5/Más_sobre_la_herencia_de_propiedades/Determinando_relaciones_de_instancia	/es/docs/Web/JavaScript/Guide/Details_of_the_Object_Model#Como_determinar_las_relaciones_entre_instancias
/es/docs/JavaScript/Guide/Obsolete_Pages/Guía_JavaScript_1.5/Más_sobre_la_herencia_de_propiedades/Herencia_no_múltiple	/es/docs/Web/JavaScript/Guide/Details_of_the_Object_Model#No_existe_herencia_multiple
/es/docs/JavaScript/Guide/Obsolete_Pages/Guía_JavaScript_1.5/Más_sobre_la_herencia_de_propiedades/Información_global_en_los_constructores	/es/docs/Web/JavaScript/Guide/Details_of_the_Object_Model#Informacion_global_en_los_constructores
/es/docs/JavaScript/Guide/Obsolete_Pages/Guía_JavaScript_1.5/Más_sobre_la_herencia_de_propiedades/Valores_locales_frente_a_los_heredados	/es/docs/Web/JavaScript/Guide/Details_of_the_Object_Model#Valores_locales_frente_a_valores_heredados
/es/docs/JavaScript/Guide/Obsolete_Pages/Guía_JavaScript_1.5/Objetos_base_predefinidos	/es/docs/Web/JavaScript/Referencia
/es/docs/JavaScript/Guide/Obsolete_Pages/Guía_JavaScript_1.5/Objetos_base_predefinidos/Objeto_Array	/es/docs/Web/JavaScript/Referencia/Objetos_globales/Array
/es/docs/JavaScript/Guide/Obsolete_Pages/Guía_JavaScript_1.5/Objetos_base_predefinidos/Objeto_Boolean	/es/docs/Web/JavaScript/Referencia/Objetos_globales/Boolean
/es/docs/JavaScript/Guide/Obsolete_Pages/Guía_JavaScript_1.5/Objetos_base_predefinidos/Objeto_Date	/es/docs/Web/JavaScript/Referencia/Objetos_globales/Date
/es/docs/JavaScript/Guide/Obsolete_Pages/Guía_JavaScript_1.5/Objetos_base_predefinidos/Objeto_Function	/es/docs/Web/JavaScript/Referencia/Objetos_globales/Function
/es/docs/JavaScript/Guide/Obsolete_Pages/Guía_JavaScript_1.5/Objetos_base_predefinidos/Objeto_Math	/es/docs/Web/JavaScript/Referencia/Objetos_globales/Math
/es/docs/JavaScript/Guide/Obsolete_Pages/Guía_JavaScript_1.5/Objetos_base_predefinidos/Objeto_Number	/es/docs/Web/JavaScript/Referencia/Objetos_globales/Number
/es/docs/JavaScript/Guide/Obsolete_Pages/Guía_JavaScript_1.5/Objetos_base_predefinidos/Objeto_RegExp	/es/docs/Web/JavaScript/Referencia/Objetos_globales/RegExp
/es/docs/JavaScript/Guide/Obsolete_Pages/Guía_JavaScript_1.5/Objetos_base_predefinidos/Objeto_String	/es/docs/Web/JavaScript/Referencia/Objetos_globales/String
/es/docs/JavaScript/Guide/Obsolete_Pages/Guía_JavaScript_1.5/Objetos_y_propiedades	/es/docs/Web/JavaScript/Guide/Trabajando_con_objectos#Objetos_y_propiedades
/es/docs/JavaScript/Guide/Obsolete_Pages/Guía_JavaScript_1.5/Operadores	/es/docs/Web/JavaScript/Guide/Expressions_and_Operators#Operadores
/es/docs/JavaScript/Guide/Obsolete_Pages/Guía_JavaScript_1.5/Operadores/Operadores_aritméticos	/es/docs/Web/JavaScript/Guide/Expressions_and_Operators#Operadores_aritm.C3.A9ticos
/es/docs/JavaScript/Guide/Obsolete_Pages/Guía_JavaScript_1.5/Operadores/Operadores_de_asignación	/es/docs/Web/JavaScript/Guide/Expressions_and_Operators#Operadores_de_asignaci.C3.B3n
/es/docs/JavaScript/Guide/Obsolete_Pages/Guía_JavaScript_1.5/Operadores/Operadores_de_cadenas_de_caracteres_(string)	/es/docs/Web/JavaScript/Guide/Expressions_and_Operators#String_operators
/es/docs/JavaScript/Guide/Obsolete_Pages/Guía_JavaScript_1.5/Operadores/Operadores_de_comparación	/es/docs/Web/JavaScript/Guide/Expressions_and_Operators#Operadores_de_comparaci.C3.B3n
/es/docs/JavaScript/Guide/Obsolete_Pages/Guía_JavaScript_1.5/Operadores/Operadores_especiales	/es/docs/Web/JavaScript/Guide/Expressions_and_Operators#Special_operators
/es/docs/JavaScript/Guide/Obsolete_Pages/Guía_JavaScript_1.5/Operadores/Operadores_lógicos	/es/docs/Web/JavaScript/Guide/Expressions_and_Operators#Operadores_l.C3.B3gicos
/es/docs/JavaScript/Guide/Obsolete_Pages/Guía_JavaScript_1.5/Operadores/Operadores_sobre_bits	/es/docs/Web/JavaScript/Guide/Expressions_and_Operators#Operadores_Bit-a-bit
/es/docs/JavaScript/Guide/Obsolete_Pages/Guía_JavaScript_1.5/Predefined_Functions	/es/docs/Web/JavaScript/Referencia/Objetos_globales
/es/docs/JavaScript/Guide/Obsolete_Pages/Guía_JavaScript_1.5/Predefined_Functions/eval_Function	/es/docs/Web/JavaScript/Referencia/Objetos_globales/eval
/es/docs/JavaScript/Guide/Obsolete_Pages/Guía_JavaScript_1.5/Sentencia_condicional	/es/docs/Web/JavaScript/Guide/Control_de_flujo_y_manejo_de_errores#Condicionales
/es/docs/JavaScript/Guide/Obsolete_Pages/Guía_JavaScript_1.5/Sentencia_de_bloque	/es/docs/Web/JavaScript/Referencia/Sentencias/block
/es/docs/JavaScript/Guide/Obsolete_Pages/Guía_JavaScript_1.5/Sentencias_de_bucle	/es/docs/Web/JavaScript/Guide/Loops_and_iteration
/es/docs/JavaScript/Guide/Obsolete_Pages/Guía_JavaScript_1.5/Sentencias_de_manejo_de_excepciones	/es/docs/Web/JavaScript/Guide/Control_de_flujo_y_manejo_de_errores#Utilizing_Error_objects
/es/docs/JavaScript/Guide/Obsolete_Pages/Guía_JavaScript_1.5/Sentencias_de_manejo_de_excepciones/throw	/es/docs/Web/JavaScript/Guide/Control_de_flujo_y_manejo_de_errores#throw_statement
/es/docs/JavaScript/Guide/Obsolete_Pages/Guía_JavaScript_1.5/Sentencias_de_manejo_de_excepciones/try...catch	/es/docs/Web/JavaScript/Guide/Control_de_flujo_y_manejo_de_errores#try...catch_statement
/es/docs/JavaScript/Guide/Obsolete_Pages/Guía_JavaScript_1.5/Sentencias_de_manipulación_de_objetos	/es/docs/Web/JavaScript/Guide
/es/docs/JavaScript/Guide/Obsolete_Pages/Guía_JavaScript_1.5/Sentencias_para_comentarios	/es/docs/Web/JavaScript/Guide
/es/docs/JavaScript/Guide/Obsolete_Pages/Guía_JavaScript_1.5/Trabajar_con_expresiones_regulares	/es/docs/Web/JavaScript/Guide/Regular_Expressions
/es/docs/JavaScript/Guide/Obsolete_Pages/Guía_JavaScript_1.5/Trabajar_con_expresiones_regulares/Ejecutar_una_busqueda_global,_discriminar_mayúsculas_y_minúsculas_y_considerar_entrada_multilínea	/es/docs/Web/JavaScript/Guide/Regular_Expressions
/es/docs/JavaScript/Guide/Obsolete_Pages/Guía_JavaScript_1.5/Trabajar_con_expresiones_regulares/Ejecutar_una_busqueda_global,_ignorar_mayusculas_minusculas,_y_considerar_entrada_multilinea	/es/docs/Guía_JavaScript_1.5/Trabajar_con_expresiones_regulares/Ejecutar_una_busqueda_global,_discriminar_mayusculas_y_minusculas_y_considerar_entrada_multilínea
/es/docs/JavaScript/Guide/Obsolete_Pages/Guía_JavaScript_1.5/Trabajar_con_expresiones_regulares/Ejemplos_de_expresiones_regulares	/es/docs/Web/JavaScript/Guide/Regular_Expressions
/es/docs/JavaScript/Guide/Obsolete_Pages/Guía_JavaScript_1.5/Trabajar_con_expresiones_regulares/Usar_coincidencias_de_subcadenas_parentizadas	/es/docs/Web/JavaScript/Guide/Regular_Expressions
/es/docs/JavaScript/Guide/Obsolete_Pages/Guía_JavaScript_1.5/Unicode	/en-US/docs/Web/JavaScript/Reference/Lexical_grammar
/es/docs/JavaScript/Guide/Obsolete_Pages/Guía_JavaScript_1.5/Usando_el_objeto_arguments	/es/docs/Web/JavaScript/Guide/Funciones
/es/docs/JavaScript/Guide/Obsolete_Pages/Guía_JavaScript_1.5/Using_the_arguments_object	/es/docs/Web/JavaScript/Guide/Funciones
/es/docs/JavaScript/Guide/Obsolete_Pages/Guía_JavaScript_1.5/Valores	/es/docs/Web/JavaScript/Guide/Grammar_and_types
/es/docs/JavaScript/Guide/Obsolete_Pages/Guía_JavaScript_1.5/Variables	/es/docs/Web/JavaScript/Guide/Grammar_and_types
/es/docs/JavaScript/Guide/Trabajando_con_objectos	/es/docs/Web/JavaScript/Guide/Trabajando_con_objectos
/es/docs/JavaScript/Guide/Valores,_variables_y_literales	/es/docs/Web/JavaScript/Guide/Grammar_and_types
/es/docs/JavaScript/Introducción_a_JavaScript_orientado_a_objetos	/es/docs/Web/JavaScript/Introducción_a_JavaScript_orientado_a_objetos
/es/docs/JavaScript/Novedades_en_JavaScript	/es/docs/Web/JavaScript/Novedades_en_JavaScript
/es/docs/JavaScript/Novedades_en_JavaScript/1.5	/es/docs/Web/JavaScript/Novedades_en_JavaScript/1.5
/es/docs/JavaScript/Novedades_en_JavaScript/1.6	/es/docs/Web/JavaScript/Novedades_en_JavaScript/1.6
/es/docs/JavaScript/Novedades_en_JavaScript/1.7	/es/docs/Web/JavaScript/Novedades_en_JavaScript/1.7
/es/docs/JavaScript/Novedades_en_JavaScript/1.8	/es/docs/Web/JavaScript/Novedades_en_JavaScript/1.8
/es/docs/JavaScript/Novedades_en_JavaScript/1.8.5	/es/docs/Web/JavaScript/Novedades_en_JavaScript/1.8.5
/es/docs/JavaScript/Novedades_en_JavaScript/Novedades_en_JavaScript_1.8.5	/es/docs/Web/JavaScript/Novedades_en_JavaScript/1.8.5
/es/docs/JavaScript/Primeros_Pasos	/es/docs/Learn/Getting_started_with_the_web/JavaScript_basics
/es/docs/JavaScript/Reference/Global_Objects/Array/push	/es/docs/Web/JavaScript/Referencia/Objetos_globales/Array/push
/es/docs/JavaScript/Reference/Global_Objects/RegExp	/es/docs/Web/JavaScript/Referencia/Objetos_globales/RegExp
/es/docs/JavaScript/Reference/Operators/function	/es/docs/Web/JavaScript/Referencia/Operadores/function
/es/docs/JavaScript/Reference/Operators/get	/es/docs/Web/JavaScript/Referencia/Funciones/get
/es/docs/JavaScript/Reference/Operators/in	/es/docs/Web/JavaScript/Referencia/Operadores/in
/es/docs/JavaScript/Reference/Operators/this	/es/docs/Web/JavaScript/Referencia/Operadores/this
/es/docs/JavaScript/Referencia	/es/docs/Web/JavaScript/Referencia
/es/docs/JavaScript/Referencia/Acerca_de	/es/docs/Web/JavaScript/Referencia/Acerca_de
/es/docs/JavaScript/Referencia/Características_Desaprobadas	/es/docs/Web/JavaScript/Referencia/Características_Desaprobadas
/es/docs/JavaScript/Referencia/Características_Despreciadas	/es/docs/Web/JavaScript/Referencia/Características_Desaprobadas
/es/docs/JavaScript/Referencia/Comentarios	/es/docs/Web/JavaScript/Referencia/Comentarios
/es/docs/JavaScript/Referencia/Comentarios/comentario	/es/docs/temp_comentarios
/es/docs/JavaScript/Referencia/Funciones	/es/docs/Web/JavaScript/Referencia/Funciones
/es/docs/JavaScript/Referencia/Funciones/String	/es/docs/Web/JavaScript/Referencia/Objetos_globales/String
/es/docs/JavaScript/Referencia/Funciones/arguments	/es/docs/Web/JavaScript/Referencia/Funciones/arguments
/es/docs/JavaScript/Referencia/Funciones/arguments/callee	/es/docs/Web/JavaScript/Referencia/Funciones/arguments/callee
/es/docs/JavaScript/Referencia/Funciones_globales	/es/docs/Web/JavaScript/Referencia/Objetos_globales
/es/docs/JavaScript/Referencia/Funciones_globales/Boolean	/es/docs/Web/JavaScript/Referencia/Objetos_globales/Boolean
/es/docs/JavaScript/Referencia/Funciones_globales/Date	/es/docs/Web/JavaScript/Referencia/Objetos_globales/Date
/es/docs/JavaScript/Referencia/Funciones_globales/Object	/es/docs/Web/JavaScript/Referencia/Objetos_globales/Object
/es/docs/JavaScript/Referencia/Funciones_globales/String	/es/docs/Web/JavaScript/Referencia/Objetos_globales/String
/es/docs/JavaScript/Referencia/Funciones_globales/decodeURI	/es/docs/Web/JavaScript/Referencia/Objetos_globales/decodeURI
/es/docs/JavaScript/Referencia/Funciones_globales/decodeURIComponent	/es/docs/Web/JavaScript/Referencia/Objetos_globales/decodeURIComponent
/es/docs/JavaScript/Referencia/Funciones_globales/encodeURI	/es/docs/Web/JavaScript/Referencia/Objetos_globales/encodeURI
/es/docs/JavaScript/Referencia/Funciones_globales/encodeURIComponent	/es/docs/Web/JavaScript/Referencia/Objetos_globales/encodeURIComponent
/es/docs/JavaScript/Referencia/Funciones_globales/eval	/es/docs/Web/JavaScript/Referencia/Objetos_globales/eval
/es/docs/JavaScript/Referencia/Funciones_globales/isFinite	/es/docs/Web/JavaScript/Referencia/Objetos_globales/isFinite
/es/docs/JavaScript/Referencia/Funciones_globales/isNaN	/es/docs/Web/JavaScript/Referencia/Objetos_globales/isNaN
/es/docs/JavaScript/Referencia/Funciones_globales/parseInt	/es/docs/Web/JavaScript/Referencia/Objetos_globales/parseInt
/es/docs/JavaScript/Referencia/Objetos_globales	/es/docs/Web/JavaScript/Referencia/Objetos_globales
/es/docs/JavaScript/Referencia/Objetos_globales/Array	/es/docs/Web/JavaScript/Referencia/Objetos_globales/Array
/es/docs/JavaScript/Referencia/Objetos_globales/Array/forEach	/es/docs/Web/JavaScript/Referencia/Objetos_globales/Array/forEach
/es/docs/JavaScript/Referencia/Objetos_globales/Array/indexOf	/es/docs/Web/JavaScript/Referencia/Objetos_globales/Array/indexOf
/es/docs/JavaScript/Referencia/Objetos_globales/Array/push	/es/docs/Web/JavaScript/Referencia/Objetos_globales/Array/push
/es/docs/JavaScript/Referencia/Objetos_globales/Array/reduce	/es/docs/Web/JavaScript/Referencia/Objetos_globales/Array/reduce
/es/docs/JavaScript/Referencia/Objetos_globales/Array/reduceRight	/es/docs/Web/JavaScript/Referencia/Objetos_globales/Array/reduceRight
/es/docs/JavaScript/Referencia/Objetos_globales/Boolean	/es/docs/Web/JavaScript/Referencia/Objetos_globales/Boolean
/es/docs/JavaScript/Referencia/Objetos_globales/Boolean/toSource	/es/docs/Web/JavaScript/Referencia/Objetos_globales/Boolean/toSource
/es/docs/JavaScript/Referencia/Objetos_globales/Date	/es/docs/Web/JavaScript/Referencia/Objetos_globales/Date
/es/docs/JavaScript/Referencia/Objetos_globales/Date/UTC	/es/docs/Web/JavaScript/Referencia/Objetos_globales/Date/UTC
/es/docs/JavaScript/Referencia/Objetos_globales/Date/now	/es/docs/Web/JavaScript/Referencia/Objetos_globales/Date/now
/es/docs/JavaScript/Referencia/Objetos_globales/Date/parse	/es/docs/Web/JavaScript/Referencia/Objetos_globales/Date/parse
/es/docs/JavaScript/Referencia/Objetos_globales/Error	/es/docs/Web/JavaScript/Referencia/Objetos_globales/Error
/es/docs/JavaScript/Referencia/Objetos_globales/Function	/es/docs/Web/JavaScript/Referencia/Objetos_globales/Function
/es/docs/JavaScript/Referencia/Objetos_globales/Function/apply	/es/docs/Web/JavaScript/Referencia/Objetos_globales/Function/apply
/es/docs/JavaScript/Referencia/Objetos_globales/Function/arguments	/es/docs/Web/JavaScript/Referencia/Objetos_globales/Function/arguments
/es/docs/JavaScript/Referencia/Objetos_globales/Function/call	/es/docs/Web/JavaScript/Referencia/Objetos_globales/Function/call
/es/docs/JavaScript/Referencia/Objetos_globales/Function/prototype	/es/docs/Web/JavaScript/Referencia/Objetos_globales/Function/prototype
/es/docs/JavaScript/Referencia/Objetos_globales/JSON	/es/docs/Web/JavaScript/Referencia/Objetos_globales/JSON
/es/docs/JavaScript/Referencia/Objetos_globales/JSON/stringify	/es/docs/Web/JavaScript/Referencia/Objetos_globales/JSON/stringify
/es/docs/JavaScript/Referencia/Objetos_globales/Math	/es/docs/Web/JavaScript/Referencia/Objetos_globales/Math
/es/docs/JavaScript/Referencia/Objetos_globales/Math/E	/es/docs/Web/JavaScript/Referencia/Objetos_globales/Math/E
/es/docs/JavaScript/Referencia/Objetos_globales/Math/LN10	/es/docs/Web/JavaScript/Referencia/Objetos_globales/Math/LN10
/es/docs/JavaScript/Referencia/Objetos_globales/Math/LN2	/es/docs/Web/JavaScript/Referencia/Objetos_globales/Math/LN2
/es/docs/JavaScript/Referencia/Objetos_globales/Math/LOG2E	/es/docs/Web/JavaScript/Referencia/Objetos_globales/Math/LOG2E
/es/docs/JavaScript/Referencia/Objetos_globales/Math/floor	/es/docs/Web/JavaScript/Referencia/Objetos_globales/Math/floor
/es/docs/JavaScript/Referencia/Objetos_globales/Number	/es/docs/Web/JavaScript/Referencia/Objetos_globales/Number
/es/docs/JavaScript/Referencia/Objetos_globales/Number/NEGATIVE_INFINITY	/es/docs/Web/JavaScript/Referencia/Objetos_globales/Number/NEGATIVE_INFINITY
/es/docs/JavaScript/Referencia/Objetos_globales/Number/POSITIVE_INFINITY	/es/docs/Web/JavaScript/Referencia/Objetos_globales/Number/POSITIVE_INFINITY
/es/docs/JavaScript/Referencia/Objetos_globales/Number/prototype	/es/docs/Web/JavaScript/Referencia/Objetos_globales/Number/prototype
/es/docs/JavaScript/Referencia/Objetos_globales/Number/toString	/es/docs/Web/JavaScript/Referencia/Objetos_globales/Number/toString
/es/docs/JavaScript/Referencia/Objetos_globales/Object	/es/docs/Web/JavaScript/Referencia/Objetos_globales/Object
/es/docs/JavaScript/Referencia/Objetos_globales/Object/constructor	/es/docs/Web/JavaScript/Referencia/Objetos_globales/Object/constructor
/es/docs/JavaScript/Referencia/Objetos_globales/Object/create	/es/docs/Web/JavaScript/Referencia/Objetos_globales/Object/create
/es/docs/JavaScript/Referencia/Objetos_globales/Object/defineProperties	/es/docs/Web/JavaScript/Referencia/Objetos_globales/Object/defineProperties
/es/docs/JavaScript/Referencia/Objetos_globales/Object/hasOwnProperty	/es/docs/Web/JavaScript/Referencia/Objetos_globales/Object/hasOwnProperty
/es/docs/JavaScript/Referencia/Objetos_globales/Object/toString	/es/docs/Web/JavaScript/Referencia/Objetos_globales/Object/toString
/es/docs/JavaScript/Referencia/Objetos_globales/Object/unwatch	/es/docs/Web/JavaScript/Referencia/Objetos_globales/Object/unwatch
/es/docs/JavaScript/Referencia/Objetos_globales/Object/watch	/es/docs/Web/JavaScript/Referencia/Objetos_globales/Object/watch
/es/docs/JavaScript/Referencia/Objetos_globales/RegExp	/es/docs/Web/JavaScript/Referencia/Objetos_globales/RegExp
/es/docs/JavaScript/Referencia/Objetos_globales/String	/es/docs/Web/JavaScript/Referencia/Objetos_globales/String
/es/docs/JavaScript/Referencia/Objetos_globales/String/anchor	/es/docs/Web/JavaScript/Referencia/Objetos_globales/String/anchor
/es/docs/JavaScript/Referencia/Objetos_globales/String/big	/es/docs/Web/JavaScript/Referencia/Objetos_globales/String/big
/es/docs/JavaScript/Referencia/Objetos_globales/String/blink	/es/docs/Web/JavaScript/Referencia/Objetos_globales/String/blink
/es/docs/JavaScript/Referencia/Objetos_globales/String/bold	/es/docs/Web/JavaScript/Referencia/Objetos_globales/String/bold
/es/docs/JavaScript/Referencia/Objetos_globales/String/charAt	/es/docs/Web/JavaScript/Referencia/Objetos_globales/String/charAt
/es/docs/JavaScript/Referencia/Objetos_globales/String/charCodeAt	/es/docs/Web/JavaScript/Referencia/Objetos_globales/String/charCodeAt
/es/docs/JavaScript/Referencia/Objetos_globales/String/concat	/es/docs/Web/JavaScript/Referencia/Objetos_globales/String/concat
/es/docs/JavaScript/Referencia/Objetos_globales/String/constructor	/es/docs/Web/JavaScript/Referencia/Objetos_globales/String
/es/docs/JavaScript/Referencia/Objetos_globales/String/fixed	/es/docs/Web/JavaScript/Referencia/Objetos_globales/String/fixed
/es/docs/JavaScript/Referencia/Objetos_globales/String/fromCharCode	/es/docs/Web/JavaScript/Referencia/Objetos_globales/String/fromCharCode
/es/docs/JavaScript/Referencia/Objetos_globales/String/indexOf	/es/docs/Web/JavaScript/Referencia/Objetos_globales/String/indexOf
/es/docs/JavaScript/Referencia/Objetos_globales/String/italics	/es/docs/Web/JavaScript/Referencia/Objetos_globales/String/italics
/es/docs/JavaScript/Referencia/Objetos_globales/String/lastIndexOf	/es/docs/Web/JavaScript/Referencia/Objetos_globales/String/lastIndexOf
/es/docs/JavaScript/Referencia/Objetos_globales/String/length	/es/docs/Web/JavaScript/Referencia/Objetos_globales/String/length
/es/docs/JavaScript/Referencia/Objetos_globales/String/link	/es/docs/Web/JavaScript/Referencia/Objetos_globales/String/link
/es/docs/JavaScript/Referencia/Objetos_globales/String/match	/es/docs/Web/JavaScript/Referencia/Objetos_globales/String/match
/es/docs/JavaScript/Referencia/Objetos_globales/String/prototype	/es/docs/Web/JavaScript/Referencia/Objetos_globales/String/prototype
/es/docs/JavaScript/Referencia/Objetos_globales/String/replace	/es/docs/Web/JavaScript/Referencia/Objetos_globales/String/replace
/es/docs/JavaScript/Referencia/Objetos_globales/String/search	/es/docs/Web/JavaScript/Referencia/Objetos_globales/String/search
/es/docs/JavaScript/Referencia/Objetos_globales/String/slice	/es/docs/Web/JavaScript/Referencia/Objetos_globales/String/slice
/es/docs/JavaScript/Referencia/Objetos_globales/String/small	/es/docs/Web/JavaScript/Referencia/Objetos_globales/String/small
/es/docs/JavaScript/Referencia/Objetos_globales/String/split	/es/docs/Web/JavaScript/Referencia/Objetos_globales/String/split
/es/docs/JavaScript/Referencia/Objetos_globales/String/strike	/es/docs/Web/JavaScript/Referencia/Objetos_globales/String/strike
/es/docs/JavaScript/Referencia/Objetos_globales/String/sub	/es/docs/Web/JavaScript/Referencia/Objetos_globales/String/sub
/es/docs/JavaScript/Referencia/Objetos_globales/String/substr	/es/docs/Web/JavaScript/Referencia/Objetos_globales/String/substr
/es/docs/JavaScript/Referencia/Objetos_globales/String/substring	/es/docs/Web/JavaScript/Referencia/Objetos_globales/String/substring
/es/docs/JavaScript/Referencia/Objetos_globales/String/sup	/es/docs/Web/JavaScript/Referencia/Objetos_globales/String/sup
/es/docs/JavaScript/Referencia/Objetos_globales/String/toLowerCase	/es/docs/Web/JavaScript/Referencia/Objetos_globales/String/toLowerCase
/es/docs/JavaScript/Referencia/Objetos_globales/String/toString	/es/docs/Web/JavaScript/Referencia/Objetos_globales/String/toString
/es/docs/JavaScript/Referencia/Objetos_globales/String/toUpperCase	/es/docs/Web/JavaScript/Referencia/Objetos_globales/String/toUpperCase
/es/docs/JavaScript/Referencia/Objetos_globales/String/valueOf	/es/docs/Web/JavaScript/Referencia/Objetos_globales/String/valueOf
/es/docs/JavaScript/Referencia/Objetos_globales/eval	/es/docs/Web/JavaScript/Referencia/Objetos_globales/eval
/es/docs/JavaScript/Referencia/Objetos_globales/parseFloat	/es/docs/Web/JavaScript/Referencia/Objetos_globales/parseFloat
/es/docs/JavaScript/Referencia/Objetos_globlales	/es/docs/Web/JavaScript/Referencia/Objetos_globales
/es/docs/JavaScript/Referencia/Objetos_globlales/Function/arguments	/es/docs/Web/JavaScript/Referencia/Objetos_globales/Function/arguments
/es/docs/JavaScript/Referencia/Operadores	/es/docs/Web/JavaScript/Referencia/Operadores
/es/docs/JavaScript/Referencia/Operadores/Aritméticos	/es/docs/Web/JavaScript/Referencia/Operadores/Aritméticos
/es/docs/JavaScript/Referencia/Operadores/Especiales	/es/docs/Web/JavaScript/Referencia/Operadores
/es/docs/JavaScript/Referencia/Operadores/Especiales/function	/es/docs/Web/JavaScript/Referencia/Operadores/function
/es/docs/JavaScript/Referencia/Operadores/Especiales/instanceof	/es/docs/Web/JavaScript/Referencia/Operadores/instanceof
/es/docs/JavaScript/Referencia/Operadores/Especiales/typeof	/es/docs/Web/JavaScript/Referencia/Operadores/typeof
/es/docs/JavaScript/Referencia/Operadores/Especiales/void	/es/docs/Web/JavaScript/Referencia/Operadores/void
/es/docs/JavaScript/Referencia/Operadores/Miembros	/es/docs/Web/JavaScript/Referencia/Operadores/Miembros
/es/docs/JavaScript/Referencia/Operadores/Operadores_especiales	/es/docs/Web/JavaScript/Referencia/Operadores
/es/docs/JavaScript/Referencia/Operadores/Operadores_especiales/Operador_this	/es/docs/Web/JavaScript/Referencia/Operadores/this
/es/docs/JavaScript/Referencia/Operadores/Operator_Precedence	/es/docs/Web/JavaScript/Referencia/Operadores/Operator_Precedence
/es/docs/JavaScript/Referencia/Operadores/String	/es/docs/Web/JavaScript/Referencia/Operadores/Aritméticos
/es/docs/JavaScript/Referencia/Operadores/function	/es/docs/Web/JavaScript/Referencia/Operadores/function
/es/docs/JavaScript/Referencia/Operadores/get	/es/docs/Web/JavaScript/Referencia/Funciones/get
/es/docs/JavaScript/Referencia/Operadores/in	/es/docs/Web/JavaScript/Referencia/Operadores/in
/es/docs/JavaScript/Referencia/Operadores/instanceof	/es/docs/Web/JavaScript/Referencia/Operadores/instanceof
/es/docs/JavaScript/Referencia/Operadores/new	/es/docs/Web/JavaScript/Referencia/Operadores/new
/es/docs/JavaScript/Referencia/Operadores/this	/es/docs/Web/JavaScript/Referencia/Operadores/this
/es/docs/JavaScript/Referencia/Operadores/typeof	/es/docs/Web/JavaScript/Referencia/Operadores/typeof
/es/docs/JavaScript/Referencia/Operadores/void	/es/docs/Web/JavaScript/Referencia/Operadores/void
/es/docs/JavaScript/Referencia/Operadores/void_	/es/docs/Web/JavaScript/Referencia/Operadores/void
/es/docs/JavaScript/Referencia/Palabras_Reservadas	/es/docs/Web/JavaScript/Referencia/Palabras_Reservadas
/es/docs/JavaScript/Referencia/Propiedades_globales	/es/docs/Web/JavaScript/Referencia/Objetos_globales
/es/docs/JavaScript/Referencia/Propiedades_globales/Infinity	/es/docs/Web/JavaScript/Referencia/Objetos_globales/Infinity
/es/docs/JavaScript/Referencia/Propiedades_globales/NaN	/es/docs/Web/JavaScript/Referencia/Objetos_globales/NaN
/es/docs/JavaScript/Referencia/Propiedades_globales/undefined	/es/docs/Web/JavaScript/Referencia/Objetos_globales/undefined
/es/docs/JavaScript/Referencia/Sentencias	/es/docs/Web/JavaScript/Referencia/Sentencias
/es/docs/JavaScript/Referencia/Sentencias/block	/es/docs/Web/JavaScript/Referencia/Sentencias/block
/es/docs/JavaScript/Referencia/Sentencias/break	/es/docs/Web/JavaScript/Referencia/Sentencias/break
/es/docs/JavaScript/Referencia/Sentencias/const	/es/docs/Web/JavaScript/Referencia/Sentencias/const
/es/docs/JavaScript/Referencia/Sentencias/continue	/es/docs/Web/JavaScript/Referencia/Sentencias/continue
/es/docs/JavaScript/Referencia/Sentencias/do...while	/es/docs/Web/JavaScript/Referencia/Sentencias/do...while
/es/docs/JavaScript/Referencia/Sentencias/export	/es/docs/Web/JavaScript/Referencia/Sentencias/export
/es/docs/JavaScript/Referencia/Sentencias/for	/es/docs/Web/JavaScript/Referencia/Sentencias/for
/es/docs/JavaScript/Referencia/Sentencias/for...in	/es/docs/Web/JavaScript/Referencia/Sentencias/for...in
/es/docs/JavaScript/Referencia/Sentencias/for_each...in	/es/docs/Web/JavaScript/Referencia/Sentencias/for_each...in
/es/docs/JavaScript/Referencia/Sentencias/function	/es/docs/Web/JavaScript/Referencia/Sentencias/function
/es/docs/JavaScript/Referencia/Sentencias/if...else	/es/docs/Web/JavaScript/Referencia/Sentencias/if...else
/es/docs/JavaScript/Referencia/Sentencias/label	/es/docs/Web/JavaScript/Referencia/Sentencias/label
/es/docs/JavaScript/Referencia/Sentencias/return	/es/docs/Web/JavaScript/Referencia/Sentencias/return
/es/docs/JavaScript/Referencia/Sentencias/throw	/es/docs/Web/JavaScript/Referencia/Sentencias/throw
/es/docs/JavaScript/Referencia/Sentencias/try...catch	/es/docs/Web/JavaScript/Referencia/Sentencias/try...catch
/es/docs/JavaScript/Referencia/Sentencias/var	/es/docs/Web/JavaScript/Referencia/Sentencias/var
/es/docs/JavaScript/Referencia/Sentencias/while	/es/docs/Web/JavaScript/Referencia/Sentencias/while
/es/docs/JavaScript/Una_nueva_introducción_a_JavaScript	/es/docs/Web/JavaScript/Una_re-introducción_a_JavaScript
/es/docs/JavaScript:Comunidad	/es/docs/JavaScript/Comunidad
/es/docs/Learn/CSS/Introduction_to_CSS	/en-US/docs/Learn/CSS/First_steps
/es/docs/Learn/CSS/Introduction_to_CSS/Cascada_y_herencia	/en-US/docs/Learn/CSS/Building_blocks/Cascade_and_inheritance
/es/docs/Learn/CSS/Introduction_to_CSS/Combinaciones_y_selectores_multiples	/en-US/docs/Learn/CSS/Building_blocks/Selectors/Combinators
/es/docs/Learn/CSS/Introduction_to_CSS/Como_funciona_CSS	/en-US/docs/Learn/CSS/First_steps/How_CSS_works
/es/docs/Learn/CSS/Introduction_to_CSS/Depuración_CSS	/en-US/docs/Learn/CSS/Building_blocks/Debugging_CSS
/es/docs/Learn/CSS/Introduction_to_CSS/Modelo_cajas	/en-US/docs/Learn/CSS/Building_blocks/The_box_model
/es/docs/Learn/CSS/Introduction_to_CSS/Pseudo-clases_y_pseudo-elementos	/en-US/docs/Learn/CSS/Building_blocks/Selectors/Pseudo-classes_and_pseudo-elements
/es/docs/Learn/CSS/Introduction_to_CSS/Selectores	/en-US/docs/Learn/CSS/Building_blocks/Selectors
/es/docs/Learn/CSS/Introduction_to_CSS/Selectores_de_Atributos	/en-US/docs/Learn/CSS/Building_blocks/Selectors/Attribute_selectors
/es/docs/Learn/CSS/Introduction_to_CSS/Selectores_simples	/en-US/docs/Learn/CSS/Building_blocks/Selectors/Type_Class_and_ID_Selectors
/es/docs/Learn/CSS/Introduction_to_CSS/Sintaxis	/en-US/docs/Learn/CSS/First_steps/How_CSS_is_structured
/es/docs/Learn/CSS/Introduction_to_CSS/Valores_y_unidades	/en-US/docs/Learn/CSS/Building_blocks/Values_and_units
/es/docs/Learn/CSS/Styling_boxes	/en-US/docs/Learn/CSS/Building_blocks
/es/docs/Learn/CSS/Styling_boxes/estilizando_tablas	/es/docs/Learn/CSS/Building_blocks/Styling_tables
/es/docs/Learn/HTML/Forms/My_first_HTML_form	/es/docs/Learn/HTML/Forms/Your_first_HTML_form
/es/docs/Localización:Comunidad	/es/docs/Localización/Comunidad
/es/docs/Lugares:Guía_para_migración_con_lugares	/es/docs/Lugares/Guía_para_migración_con_lugares
/es/docs/MDC	/en-US/docs/Project:es/Como_ayudar
/es/docs/MDN/Comenzando	/es/docs/MDN/Contribute/Getting_started
/es/docs/MDN/Contribute/Content	/es/docs/MDN/Guidelines
/es/docs/MDN/Contribute/Content/Content_blocks	/es/docs/MDN/Guidelines/Content_blocks
/es/docs/MDN/Contribute/Guidelines	/es/docs/MDN/Guidelines
/es/docs/MDN/Contribute/Guidelines/Content_blocks	/es/docs/MDN/Guidelines/Content_blocks
/es/docs/MDN/Contribute/Guidelines/Convenciones_y_definiciones	/es/docs/MDN/Guidelines/Convenciones_y_definiciones
/es/docs/MDN/Contribute/Guidelines/Project:Guía_de_estilo	/es/docs/MDN/Guidelines/Project:Guía_de_estilo
/es/docs/MDN/Contribute/Herramientas	/es/docs/MDN/Tools
/es/docs/MDN/Contribute/Herramientas/Page_regeneration	/es/docs/MDN/Tools/Page_regeneration
/es/docs/MDN/Contribute/Herramientas/Template_editing	/es/docs/MDN/Tools/Template_editing
/es/docs/MDN/Contribute/Structures	/es/docs/MDN/Structures
/es/docs/MDN/Contribute/Structures/Ejemplos_ejecutables	/es/docs/MDN/Structures/Ejemplos_ejecutables
/es/docs/MDN/Contribute/Structures/Macros	/es/docs/MDN/Structures/Macros
/es/docs/MDN/Contribute/Structures/Macros/Commonly-used_macros	/es/docs/MDN/Structures/Macros/Commonly-used_macros
/es/docs/MDN/Contribute/Structures/Macros/Otras	/es/docs/MDN/Structures/Macros/Otras
/es/docs/MDN/Contribute/Structures/Tablas_de_compatibilidad	/es/docs/MDN/Structures/Tablas_de_compatibilidad
/es/docs/MDN/Enviar_feedback_sobre_MDN	/es/docs/MDN/Contribute/Feedback
/es/docs/MDN/Kuma/Introduction_to_KumaScript	/es/docs/MDN/Tools/Introduction_to_KumaScript
/es/docs/Manipular_video_por_medio_de_canvas	/es/docs/Web/HTML/anipular_video_por_medio_de_canvas
/es/docs/MathML	/es/docs/Web/MathML
/es/docs/MathML/Elemento	/es/docs/Web/MathML/Elemento
/es/docs/Monitoring_downloads	/es/docs/Vigilar_descargas
/es/docs/Mozilla_Source_Code_Directory_Structure	/es/docs/Mozilla/Developer_guide/Source_Code/Mozilla_Source_Code_Directory_Structure
/es/docs/Novedades_en_JavaScript_1.6	/es/docs/Web/JavaScript/Novedades_en_JavaScript/1.6
/es/docs/Novedades_en_JavaScript_1.7	/es/docs/Web/JavaScript/Novedades_en_JavaScript/1.7
/es/docs/Novedades_en_JavaScript_1.8	/es/docs/Web/JavaScript/Novedades_en_JavaScript/1.8
/es/docs/Novedades_en_Javascript_1.5	/es/docs/Web/JavaScript/Novedades_en_JavaScript/1.5
/es/docs/Participando_en_el_proyecto_Mozilla	/es/docs/Participar_en_el_proyecto_Mozilla
/es/docs/Places:Migration_Guide	/es/docs/Places/Migration_Guide
/es/docs/Plugins:Comunidad	/es/docs/Plugins/Comunidad
/es/docs/Poniendo_al_día_extensiones_para_Firefox_3	/es/docs/Actualizar_extensiones_para_Firefox_3/Actualizar_extensiones_para_Firefox_3
/es/docs/Portada	/es/docs/Web
/es/docs/Preguntas_frecuentes_sobre_CSS	/es/docs/Web/CSS/Preguntas_frecuentes_sobre_CSS
/es/docs/Preguntas_frecuentes_sobre_incrustación_en_Mozilla:Introducción_a_Gecko_e_inscrustación	/es/docs/Preguntas_frecuentes_sobre_incrustación_en_Mozilla/Introducción_a_Gecko_e_inscrustación
/es/docs/Preguntas_frecuentes_sobre_la_compilación_de_Mozilla	/es/docs/Mozilla/Developer_guide/Preguntas_frecuentes_sobre_la_compilación_de_Mozilla
/es/docs/Quirks_Mode_and_Standards_Mode	/es/docs/Web/HTML/Quirks_Mode_and_Standards_Mode
/es/docs/RSS:Comunidad	/es/docs/RSS/Comunidad
/es/docs/Recursos_offline_en_firefox	/es/docs/Web/HTML/Recursos_offline_en_firefox
/es/docs/Referencia_CSS	/es/docs/Web/CSS/Referencia_CSS
/es/docs/Referencia_CSS/Extensiones_CSS_Mozilla	/es/docs/Web/CSS/Mozilla_Extensions
/es/docs/Referencia_CSS/Extensiones_Mozilla	/es/docs/Web/CSS/Mozilla_Extensions
/es/docs/Referencia_CSS:Extensiones_Mozilla	/es/docs/Web/CSS/Mozilla_Extensions
/es/docs/Referencia_DOM_de_Gecko:Ejemplos	/es/docs/Referencia_DOM_de_Gecko/Ejemplos
/es/docs/Referencia_DOM_de_Gecko:Introducción	/es/docs/Referencia_DOM_de_Gecko/Introducción
/es/docs/Referencia_DOM_de_Gecko:Prefacio	/es/docs/Referencia_DOM_de_Gecko/Prefacio
/es/docs/Referencia_de_JavaScript_1.5	/es/docs/Web/JavaScript/Referencia
/es/docs/Referencia_de_JavaScript_1.5/Acerca_de	/es/docs/Web/JavaScript/Referencia/Acerca_de
/es/docs/Referencia_de_JavaScript_1.5/Características_Desaprobadas	/es/docs/Web/JavaScript/Referencia/Características_Desaprobadas
/es/docs/Referencia_de_JavaScript_1.5/Características_Despreciadas	/es/docs/Web/JavaScript/Referencia/Características_Desaprobadas
/es/docs/Referencia_de_JavaScript_1.5/Comentarios	/es/docs/Web/JavaScript/Referencia/Comentarios
/es/docs/Referencia_de_JavaScript_1.5/Comentarios/comentario	/es/docs/temp_comentarios
/es/docs/Referencia_de_JavaScript_1.5/Funciones	/es/docs/Web/JavaScript/Referencia/Funciones
/es/docs/Referencia_de_JavaScript_1.5/Funciones/String	/es/docs/Web/JavaScript/Referencia/Objetos_globales/String
/es/docs/Referencia_de_JavaScript_1.5/Funciones/arguments	/es/docs/Web/JavaScript/Referencia/Funciones/arguments
/es/docs/Referencia_de_JavaScript_1.5/Funciones/arguments/callee	/es/docs/Web/JavaScript/Referencia/Funciones/arguments/callee
/es/docs/Referencia_de_JavaScript_1.5/Funciones_globales	/es/docs/Web/JavaScript/Referencia/Objetos_globales
/es/docs/Referencia_de_JavaScript_1.5/Funciones_globales/Boolean	/es/docs/Web/JavaScript/Referencia/Objetos_globales/Boolean
/es/docs/Referencia_de_JavaScript_1.5/Funciones_globales/Date	/es/docs/Web/JavaScript/Referencia/Objetos_globales/Date
/es/docs/Referencia_de_JavaScript_1.5/Funciones_globales/Number	/es/docs/JavaScript/Referencia/Funciones_globales/Number
/es/docs/Referencia_de_JavaScript_1.5/Funciones_globales/Object	/es/docs/Web/JavaScript/Referencia/Objetos_globales/Object
/es/docs/Referencia_de_JavaScript_1.5/Funciones_globales/String	/es/docs/Web/JavaScript/Referencia/Objetos_globales/String
/es/docs/Referencia_de_JavaScript_1.5/Funciones_globales/decodeURI	/es/docs/Web/JavaScript/Referencia/Objetos_globales/decodeURI
/es/docs/Referencia_de_JavaScript_1.5/Funciones_globales/decodeURIComponent	/es/docs/Web/JavaScript/Referencia/Objetos_globales/decodeURIComponent
/es/docs/Referencia_de_JavaScript_1.5/Funciones_globales/encodeURI	/es/docs/Web/JavaScript/Referencia/Objetos_globales/encodeURI
/es/docs/Referencia_de_JavaScript_1.5/Funciones_globales/encodeURIComponent	/es/docs/Web/JavaScript/Referencia/Objetos_globales/encodeURIComponent
/es/docs/Referencia_de_JavaScript_1.5/Funciones_globales/eval	/es/docs/Web/JavaScript/Referencia/Objetos_globales/eval
/es/docs/Referencia_de_JavaScript_1.5/Funciones_globales/isFinite	/es/docs/Web/JavaScript/Referencia/Objetos_globales/isFinite
/es/docs/Referencia_de_JavaScript_1.5/Funciones_globales/isNaN	/es/docs/Web/JavaScript/Referencia/Objetos_globales/isNaN
/es/docs/Referencia_de_JavaScript_1.5/Funciones_globales/parseFloat	/es/docs/Web/JavaScript/Referencia/Objetos_globales/parseFloat
/es/docs/Referencia_de_JavaScript_1.5/Funciones_globales/parseInt	/es/docs/Web/JavaScript/Referencia/Objetos_globales/parseInt
/es/docs/Referencia_de_JavaScript_1.5/Functions	/es/docs/JavaScript/Referencia/Functions
/es/docs/Referencia_de_JavaScript_1.5/Objetos_globales	/es/docs/Web/JavaScript/Referencia/Objetos_globales
/es/docs/Referencia_de_JavaScript_1.5/Objetos_globales/Array	/es/docs/Web/JavaScript/Referencia/Objetos_globales/Array
/es/docs/Referencia_de_JavaScript_1.5/Objetos_globales/Array/forEach	/es/docs/Web/JavaScript/Referencia/Objetos_globales/Array/forEach
/es/docs/Referencia_de_JavaScript_1.5/Objetos_globales/Array/indexOf	/es/docs/Web/JavaScript/Referencia/Objetos_globales/Array/indexOf
/es/docs/Referencia_de_JavaScript_1.5/Objetos_globales/Array/push	/es/docs/Web/JavaScript/Referencia/Objetos_globales/Array/push
/es/docs/Referencia_de_JavaScript_1.5/Objetos_globales/Array/reduce	/es/docs/Web/JavaScript/Referencia/Objetos_globales/Array/reduce
/es/docs/Referencia_de_JavaScript_1.5/Objetos_globales/Array/reduceRight	/es/docs/Web/JavaScript/Referencia/Objetos_globales/Array/reduceRight
/es/docs/Referencia_de_JavaScript_1.5/Objetos_globales/Boolean	/es/docs/Web/JavaScript/Referencia/Objetos_globales/Boolean
/es/docs/Referencia_de_JavaScript_1.5/Objetos_globales/Boolean/toSource	/es/docs/Web/JavaScript/Referencia/Objetos_globales/Boolean/toSource
/es/docs/Referencia_de_JavaScript_1.5/Objetos_globales/Date	/es/docs/Web/JavaScript/Referencia/Objetos_globales/Date
/es/docs/Referencia_de_JavaScript_1.5/Objetos_globales/Date/UTC	/es/docs/Web/JavaScript/Referencia/Objetos_globales/Date/UTC
/es/docs/Referencia_de_JavaScript_1.5/Objetos_globales/Date/now	/es/docs/Web/JavaScript/Referencia/Objetos_globales/Date/now
/es/docs/Referencia_de_JavaScript_1.5/Objetos_globales/Date/parse	/es/docs/Web/JavaScript/Referencia/Objetos_globales/Date/parse
/es/docs/Referencia_de_JavaScript_1.5/Objetos_globales/Error	/es/docs/Web/JavaScript/Referencia/Objetos_globales/Error
/es/docs/Referencia_de_JavaScript_1.5/Objetos_globales/Function	/es/docs/Web/JavaScript/Referencia/Objetos_globales/Function
/es/docs/Referencia_de_JavaScript_1.5/Objetos_globales/Function/apply	/es/docs/Web/JavaScript/Referencia/Objetos_globales/Function/apply
/es/docs/Referencia_de_JavaScript_1.5/Objetos_globales/Function/call	/es/docs/Web/JavaScript/Referencia/Objetos_globales/Function/call
/es/docs/Referencia_de_JavaScript_1.5/Objetos_globales/Function/prototype	/es/docs/Web/JavaScript/Referencia/Objetos_globales/Function/prototype
/es/docs/Referencia_de_JavaScript_1.5/Objetos_globales/JSON	/es/docs/Web/JavaScript/Referencia/Objetos_globales/JSON
/es/docs/Referencia_de_JavaScript_1.5/Objetos_globales/JSON/stringify	/es/docs/Web/JavaScript/Referencia/Objetos_globales/JSON/stringify
/es/docs/Referencia_de_JavaScript_1.5/Objetos_globales/Math	/es/docs/Web/JavaScript/Referencia/Objetos_globales/Math
/es/docs/Referencia_de_JavaScript_1.5/Objetos_globales/Math/E	/es/docs/Web/JavaScript/Referencia/Objetos_globales/Math/E
/es/docs/Referencia_de_JavaScript_1.5/Objetos_globales/Math/LN10	/es/docs/Web/JavaScript/Referencia/Objetos_globales/Math/LN10
/es/docs/Referencia_de_JavaScript_1.5/Objetos_globales/Math/LN2	/es/docs/Web/JavaScript/Referencia/Objetos_globales/Math/LN2
/es/docs/Referencia_de_JavaScript_1.5/Objetos_globales/Math/LOG2E	/es/docs/Web/JavaScript/Referencia/Objetos_globales/Math/LOG2E
/es/docs/Referencia_de_JavaScript_1.5/Objetos_globales/Math/floor	/es/docs/Web/JavaScript/Referencia/Objetos_globales/Math/floor
/es/docs/Referencia_de_JavaScript_1.5/Objetos_globales/Number	/es/docs/Web/JavaScript/Referencia/Objetos_globales/Number
/es/docs/Referencia_de_JavaScript_1.5/Objetos_globales/Number/NEGATIVE_INFINITY	/es/docs/Web/JavaScript/Referencia/Objetos_globales/Number/NEGATIVE_INFINITY
/es/docs/Referencia_de_JavaScript_1.5/Objetos_globales/Number/POSITIVE_INFINITY	/es/docs/Web/JavaScript/Referencia/Objetos_globales/Number/POSITIVE_INFINITY
/es/docs/Referencia_de_JavaScript_1.5/Objetos_globales/Number/prototype	/es/docs/Web/JavaScript/Referencia/Objetos_globales/Number/prototype
/es/docs/Referencia_de_JavaScript_1.5/Objetos_globales/Number/toString	/es/docs/Web/JavaScript/Referencia/Objetos_globales/Number/toString
/es/docs/Referencia_de_JavaScript_1.5/Objetos_globales/Object	/es/docs/Web/JavaScript/Referencia/Objetos_globales/Object
/es/docs/Referencia_de_JavaScript_1.5/Objetos_globales/Object/constructor	/es/docs/Web/JavaScript/Referencia/Objetos_globales/Object/constructor
/es/docs/Referencia_de_JavaScript_1.5/Objetos_globales/Object/create	/es/docs/Web/JavaScript/Referencia/Objetos_globales/Object/create
/es/docs/Referencia_de_JavaScript_1.5/Objetos_globales/Object/defineProperties	/es/docs/Web/JavaScript/Referencia/Objetos_globales/Object/defineProperties
/es/docs/Referencia_de_JavaScript_1.5/Objetos_globales/Object/hasOwnProperty	/es/docs/Web/JavaScript/Referencia/Objetos_globales/Object/hasOwnProperty
/es/docs/Referencia_de_JavaScript_1.5/Objetos_globales/Object/toString	/es/docs/Web/JavaScript/Referencia/Objetos_globales/Object/toString
/es/docs/Referencia_de_JavaScript_1.5/Objetos_globales/Object/unwatch	/es/docs/Web/JavaScript/Referencia/Objetos_globales/Object/unwatch
/es/docs/Referencia_de_JavaScript_1.5/Objetos_globales/Object/watch	/es/docs/Web/JavaScript/Referencia/Objetos_globales/Object/watch
/es/docs/Referencia_de_JavaScript_1.5/Objetos_globales/RegExp	/es/docs/Web/JavaScript/Referencia/Objetos_globales/RegExp
/es/docs/Referencia_de_JavaScript_1.5/Objetos_globales/String	/es/docs/Web/JavaScript/Referencia/Objetos_globales/String
/es/docs/Referencia_de_JavaScript_1.5/Objetos_globales/String/anchor	/es/docs/Web/JavaScript/Referencia/Objetos_globales/String/anchor
/es/docs/Referencia_de_JavaScript_1.5/Objetos_globales/String/big	/es/docs/Web/JavaScript/Referencia/Objetos_globales/String/big
/es/docs/Referencia_de_JavaScript_1.5/Objetos_globales/String/blink	/es/docs/Web/JavaScript/Referencia/Objetos_globales/String/blink
/es/docs/Referencia_de_JavaScript_1.5/Objetos_globales/String/bold	/es/docs/Web/JavaScript/Referencia/Objetos_globales/String/bold
/es/docs/Referencia_de_JavaScript_1.5/Objetos_globales/String/charAt	/es/docs/Web/JavaScript/Referencia/Objetos_globales/String/charAt
/es/docs/Referencia_de_JavaScript_1.5/Objetos_globales/String/charCodeAt	/es/docs/Web/JavaScript/Referencia/Objetos_globales/String/charCodeAt
/es/docs/Referencia_de_JavaScript_1.5/Objetos_globales/String/concat	/es/docs/Web/JavaScript/Referencia/Objetos_globales/String/concat
/es/docs/Referencia_de_JavaScript_1.5/Objetos_globales/String/constructor	/es/docs/Web/JavaScript/Referencia/Objetos_globales/String
/es/docs/Referencia_de_JavaScript_1.5/Objetos_globales/String/fixed	/es/docs/Web/JavaScript/Referencia/Objetos_globales/String/fixed
/es/docs/Referencia_de_JavaScript_1.5/Objetos_globales/String/fromCharCode	/es/docs/Web/JavaScript/Referencia/Objetos_globales/String/fromCharCode
/es/docs/Referencia_de_JavaScript_1.5/Objetos_globales/String/indexOf	/es/docs/Web/JavaScript/Referencia/Objetos_globales/String/indexOf
/es/docs/Referencia_de_JavaScript_1.5/Objetos_globales/String/italics	/es/docs/Web/JavaScript/Referencia/Objetos_globales/String/italics
/es/docs/Referencia_de_JavaScript_1.5/Objetos_globales/String/lastIndexOf	/es/docs/Web/JavaScript/Referencia/Objetos_globales/String/lastIndexOf
/es/docs/Referencia_de_JavaScript_1.5/Objetos_globales/String/length	/es/docs/Web/JavaScript/Referencia/Objetos_globales/String/length
/es/docs/Referencia_de_JavaScript_1.5/Objetos_globales/String/link	/es/docs/Web/JavaScript/Referencia/Objetos_globales/String/link
/es/docs/Referencia_de_JavaScript_1.5/Objetos_globales/String/match	/es/docs/Web/JavaScript/Referencia/Objetos_globales/String/match
/es/docs/Referencia_de_JavaScript_1.5/Objetos_globales/String/prototype	/es/docs/Web/JavaScript/Referencia/Objetos_globales/String/prototype
/es/docs/Referencia_de_JavaScript_1.5/Objetos_globales/String/replace	/es/docs/Web/JavaScript/Referencia/Objetos_globales/String/replace
/es/docs/Referencia_de_JavaScript_1.5/Objetos_globales/String/search	/es/docs/Web/JavaScript/Referencia/Objetos_globales/String/search
/es/docs/Referencia_de_JavaScript_1.5/Objetos_globales/String/slice	/es/docs/Web/JavaScript/Referencia/Objetos_globales/String/slice
/es/docs/Referencia_de_JavaScript_1.5/Objetos_globales/String/small	/es/docs/Web/JavaScript/Referencia/Objetos_globales/String/small
/es/docs/Referencia_de_JavaScript_1.5/Objetos_globales/String/split	/es/docs/Web/JavaScript/Referencia/Objetos_globales/String/split
/es/docs/Referencia_de_JavaScript_1.5/Objetos_globales/String/strike	/es/docs/Web/JavaScript/Referencia/Objetos_globales/String/strike
/es/docs/Referencia_de_JavaScript_1.5/Objetos_globales/String/sub	/es/docs/Web/JavaScript/Referencia/Objetos_globales/String/sub
/es/docs/Referencia_de_JavaScript_1.5/Objetos_globales/String/substr	/es/docs/Web/JavaScript/Referencia/Objetos_globales/String/substr
/es/docs/Referencia_de_JavaScript_1.5/Objetos_globales/String/substring	/es/docs/Web/JavaScript/Referencia/Objetos_globales/String/substring
/es/docs/Referencia_de_JavaScript_1.5/Objetos_globales/String/sup	/es/docs/Web/JavaScript/Referencia/Objetos_globales/String/sup
/es/docs/Referencia_de_JavaScript_1.5/Objetos_globales/String/toLowerCase	/es/docs/Web/JavaScript/Referencia/Objetos_globales/String/toLowerCase
/es/docs/Referencia_de_JavaScript_1.5/Objetos_globales/String/toString	/es/docs/Web/JavaScript/Referencia/Objetos_globales/String/toString
/es/docs/Referencia_de_JavaScript_1.5/Objetos_globales/String/toUpperCase	/es/docs/Web/JavaScript/Referencia/Objetos_globales/String/toUpperCase
/es/docs/Referencia_de_JavaScript_1.5/Objetos_globales/String/valueOf	/es/docs/Web/JavaScript/Referencia/Objetos_globales/String/valueOf
/es/docs/Referencia_de_JavaScript_1.5/Objetos_globlales	/es/docs/Web/JavaScript/Referencia/Objetos_globales
/es/docs/Referencia_de_JavaScript_1.5/Objetos_globlales/Function	/es/docs/JavaScript/Referencia/Objetos_globlales/Function
/es/docs/Referencia_de_JavaScript_1.5/Objetos_globlales/Function/arguments	/es/docs/Web/JavaScript/Referencia/Objetos_globales/Function/arguments
/es/docs/Referencia_de_JavaScript_1.5/Operadores	/es/docs/Web/JavaScript/Referencia/Operadores
/es/docs/Referencia_de_JavaScript_1.5/Operadores/Aritméticos	/es/docs/Web/JavaScript/Referencia/Operadores/Aritméticos
/es/docs/Referencia_de_JavaScript_1.5/Operadores/Especiales	/es/docs/Web/JavaScript/Referencia/Operadores
/es/docs/Referencia_de_JavaScript_1.5/Operadores/Especiales/function	/es/docs/Web/JavaScript/Referencia/Operadores/function
/es/docs/Referencia_de_JavaScript_1.5/Operadores/Especiales/instanceof	/es/docs/Web/JavaScript/Referencia/Operadores/instanceof
/es/docs/Referencia_de_JavaScript_1.5/Operadores/Especiales/typeof	/es/docs/Web/JavaScript/Referencia/Operadores/typeof
/es/docs/Referencia_de_JavaScript_1.5/Operadores/Especiales/void	/es/docs/Web/JavaScript/Referencia/Operadores/void
/es/docs/Referencia_de_JavaScript_1.5/Operadores/Miembros	/es/docs/Web/JavaScript/Referencia/Operadores/Miembros
/es/docs/Referencia_de_JavaScript_1.5/Operadores/Operadores_especiales	/es/docs/Web/JavaScript/Referencia/Operadores
/es/docs/Referencia_de_JavaScript_1.5/Operadores/Operadores_especiales/Operador_this	/es/docs/Web/JavaScript/Referencia/Operadores/this
/es/docs/Referencia_de_JavaScript_1.5/Operadores/Operator_Precedence	/es/docs/Web/JavaScript/Referencia/Operadores/Operator_Precedence
/es/docs/Referencia_de_JavaScript_1.5/Operadores/String	/es/docs/Web/JavaScript/Referencia/Operadores/Aritméticos
/es/docs/Referencia_de_JavaScript_1.5/Operadores/function	/es/docs/Web/JavaScript/Referencia/Operadores/function
/es/docs/Referencia_de_JavaScript_1.5/Operadores/get	/es/docs/Web/JavaScript/Referencia/Funciones/get
/es/docs/Referencia_de_JavaScript_1.5/Operadores/in	/es/docs/Web/JavaScript/Referencia/Operadores/in
/es/docs/Referencia_de_JavaScript_1.5/Operadores/new	/es/docs/Web/JavaScript/Referencia/Operadores/new
/es/docs/Referencia_de_JavaScript_1.5/Operadores/this	/es/docs/Web/JavaScript/Referencia/Operadores/this
/es/docs/Referencia_de_JavaScript_1.5/Palabras_Reservadas	/es/docs/Web/JavaScript/Referencia/Palabras_Reservadas
/es/docs/Referencia_de_JavaScript_1.5/Propiedades_globales	/es/docs/Web/JavaScript/Referencia/Objetos_globales
/es/docs/Referencia_de_JavaScript_1.5/Propiedades_globales/Infinity	/es/docs/Web/JavaScript/Referencia/Objetos_globales/Infinity
/es/docs/Referencia_de_JavaScript_1.5/Propiedades_globales/NaN	/es/docs/Web/JavaScript/Referencia/Objetos_globales/NaN
/es/docs/Referencia_de_JavaScript_1.5/Propiedades_globales/undefined	/es/docs/Web/JavaScript/Referencia/Objetos_globales/undefined
/es/docs/Referencia_de_JavaScript_1.5/Sentencias	/es/docs/Web/JavaScript/Referencia/Sentencias
/es/docs/Referencia_de_JavaScript_1.5/Sentencias/block	/es/docs/Web/JavaScript/Referencia/Sentencias/block
/es/docs/Referencia_de_JavaScript_1.5/Sentencias/break	/es/docs/Web/JavaScript/Referencia/Sentencias/break
/es/docs/Referencia_de_JavaScript_1.5/Sentencias/const	/es/docs/Web/JavaScript/Referencia/Sentencias/const
/es/docs/Referencia_de_JavaScript_1.5/Sentencias/continue	/es/docs/Web/JavaScript/Referencia/Sentencias/continue
/es/docs/Referencia_de_JavaScript_1.5/Sentencias/do...while	/es/docs/Web/JavaScript/Referencia/Sentencias/do...while
/es/docs/Referencia_de_JavaScript_1.5/Sentencias/export	/es/docs/Web/JavaScript/Referencia/Sentencias/export
/es/docs/Referencia_de_JavaScript_1.5/Sentencias/for	/es/docs/Web/JavaScript/Referencia/Sentencias/for
/es/docs/Referencia_de_JavaScript_1.5/Sentencias/for...in	/es/docs/Web/JavaScript/Referencia/Sentencias/for...in
/es/docs/Referencia_de_JavaScript_1.5/Sentencias/for_each...in	/es/docs/Web/JavaScript/Referencia/Sentencias/for_each...in
/es/docs/Referencia_de_JavaScript_1.5/Sentencias/function	/es/docs/Web/JavaScript/Referencia/Sentencias/function
/es/docs/Referencia_de_JavaScript_1.5/Sentencias/if...else	/es/docs/Web/JavaScript/Referencia/Sentencias/if...else
/es/docs/Referencia_de_JavaScript_1.5/Sentencias/label	/es/docs/Web/JavaScript/Referencia/Sentencias/label
/es/docs/Referencia_de_JavaScript_1.5/Sentencias/return	/es/docs/Web/JavaScript/Referencia/Sentencias/return
/es/docs/Referencia_de_JavaScript_1.5/Sentencias/throw	/es/docs/Web/JavaScript/Referencia/Sentencias/throw
/es/docs/Referencia_de_JavaScript_1.5/Sentencias/try...catch	/es/docs/Web/JavaScript/Referencia/Sentencias/try...catch
/es/docs/Referencia_de_JavaScript_1.5/Sentencias/var	/es/docs/Web/JavaScript/Referencia/Sentencias/var
/es/docs/Referencia_de_JavaScript_1.5/Sentencias/while	/es/docs/Web/JavaScript/Referencia/Sentencias/while
/es/docs/Referencia_de_JavaScript_1.5:Acerca_de	/es/docs/Web/JavaScript/Referencia/Acerca_de
/es/docs/Referencia_de_JavaScript_1.5:Características_Desaprobadas	/es/docs/Web/JavaScript/Referencia/Características_Desaprobadas
/es/docs/Referencia_de_JavaScript_1.5:Características_Despreciadas	/es/docs/Web/JavaScript/Referencia/Características_Desaprobadas
/es/docs/Referencia_de_JavaScript_1.5:Comentarios:comentario	/es/docs/temp_comentarios
/es/docs/Referencia_de_JavaScript_1.5:Funciones	/es/docs/Web/JavaScript/Referencia/Funciones
/es/docs/Referencia_de_JavaScript_1.5:Funciones:String	/es/docs/Web/JavaScript/Referencia/Objetos_globales/String
/es/docs/Referencia_de_JavaScript_1.5:Funciones:arguments	/es/docs/Web/JavaScript/Referencia/Funciones/arguments
/es/docs/Referencia_de_JavaScript_1.5:Funciones:arguments:callee	/es/docs/Web/JavaScript/Referencia/Funciones/arguments/callee
/es/docs/Referencia_de_JavaScript_1.5:Funciones_globales	/es/docs/Web/JavaScript/Referencia/Objetos_globales
/es/docs/Referencia_de_JavaScript_1.5:Funciones_globales:Boolean	/es/docs/Web/JavaScript/Referencia/Objetos_globales/Boolean
/es/docs/Referencia_de_JavaScript_1.5:Funciones_globales:Date	/es/docs/Web/JavaScript/Referencia/Objetos_globales/Date
/es/docs/Referencia_de_JavaScript_1.5:Funciones_globales:Number	/es/docs/JavaScript/Referencia/Funciones_globales/Number
/es/docs/Referencia_de_JavaScript_1.5:Funciones_globales:Object	/es/docs/Web/JavaScript/Referencia/Objetos_globales/Object
/es/docs/Referencia_de_JavaScript_1.5:Funciones_globales:String	/es/docs/Web/JavaScript/Referencia/Objetos_globales/String
/es/docs/Referencia_de_JavaScript_1.5:Funciones_globales:decodeURI	/es/docs/Web/JavaScript/Referencia/Objetos_globales/decodeURI
/es/docs/Referencia_de_JavaScript_1.5:Funciones_globales:decodeURIComponent	/es/docs/Web/JavaScript/Referencia/Objetos_globales/decodeURIComponent
/es/docs/Referencia_de_JavaScript_1.5:Funciones_globales:encodeURI	/es/docs/Web/JavaScript/Referencia/Objetos_globales/encodeURI
/es/docs/Referencia_de_JavaScript_1.5:Funciones_globales:encodeURIComponent	/es/docs/Web/JavaScript/Referencia/Objetos_globales/encodeURIComponent
/es/docs/Referencia_de_JavaScript_1.5:Funciones_globales:eval	/es/docs/Web/JavaScript/Referencia/Objetos_globales/eval
/es/docs/Referencia_de_JavaScript_1.5:Funciones_globales:isFinite	/es/docs/Web/JavaScript/Referencia/Objetos_globales/isFinite
/es/docs/Referencia_de_JavaScript_1.5:Funciones_globales:isNaN	/es/docs/Web/JavaScript/Referencia/Objetos_globales/isNaN
/es/docs/Referencia_de_JavaScript_1.5:Funciones_globales:parseFloat	/es/docs/Web/JavaScript/Referencia/Objetos_globales/parseFloat
/es/docs/Referencia_de_JavaScript_1.5:Funciones_globales:parseInt	/es/docs/Web/JavaScript/Referencia/Objetos_globales/parseInt
/es/docs/Referencia_de_JavaScript_1.5:Objetos_globales	/es/docs/Web/JavaScript/Referencia/Objetos_globales
/es/docs/Referencia_de_JavaScript_1.5:Objetos_globales:Array	/es/docs/Web/JavaScript/Referencia/Objetos_globales/Array
/es/docs/Referencia_de_JavaScript_1.5:Objetos_globales:Array:reduce	/es/docs/Web/JavaScript/Referencia/Objetos_globales/Array/reduce
/es/docs/Referencia_de_JavaScript_1.5:Objetos_globales:Array:reduceRight	/es/docs/Web/JavaScript/Referencia/Objetos_globales/Array/reduceRight
/es/docs/Referencia_de_JavaScript_1.5:Objetos_globales:Boolean	/es/docs/Web/JavaScript/Referencia/Objetos_globales/Boolean
/es/docs/Referencia_de_JavaScript_1.5:Objetos_globales:Boolean:toSource	/es/docs/Web/JavaScript/Referencia/Objetos_globales/Boolean/toSource
/es/docs/Referencia_de_JavaScript_1.5:Objetos_globales:Date	/es/docs/Web/JavaScript/Referencia/Objetos_globales/Date
/es/docs/Referencia_de_JavaScript_1.5:Objetos_globales:Date:UTC	/es/docs/Web/JavaScript/Referencia/Objetos_globales/Date/UTC
/es/docs/Referencia_de_JavaScript_1.5:Objetos_globales:Date:now	/es/docs/Web/JavaScript/Referencia/Objetos_globales/Date/now
/es/docs/Referencia_de_JavaScript_1.5:Objetos_globales:Date:parse	/es/docs/Web/JavaScript/Referencia/Objetos_globales/Date/parse
/es/docs/Referencia_de_JavaScript_1.5:Objetos_globales:Error	/es/docs/Web/JavaScript/Referencia/Objetos_globales/Error
/es/docs/Referencia_de_JavaScript_1.5:Objetos_globales:Function	/es/docs/Web/JavaScript/Referencia/Objetos_globales/Function
/es/docs/Referencia_de_JavaScript_1.5:Objetos_globales:Function:prototype	/es/docs/Web/JavaScript/Referencia/Objetos_globales/Function/prototype
/es/docs/Referencia_de_JavaScript_1.5:Objetos_globales:Math	/es/docs/Web/JavaScript/Referencia/Objetos_globales/Math
/es/docs/Referencia_de_JavaScript_1.5:Objetos_globales:Number	/es/docs/Web/JavaScript/Referencia/Objetos_globales/Number
/es/docs/Referencia_de_JavaScript_1.5:Objetos_globales:Number:prototype	/es/docs/Web/JavaScript/Referencia/Objetos_globales/Number/prototype
/es/docs/Referencia_de_JavaScript_1.5:Objetos_globales:Number:toString	/es/docs/Web/JavaScript/Referencia/Objetos_globales/Number/toString
/es/docs/Referencia_de_JavaScript_1.5:Objetos_globales:Object	/es/docs/Web/JavaScript/Referencia/Objetos_globales/Object
/es/docs/Referencia_de_JavaScript_1.5:Objetos_globales:Object:toString	/es/docs/Web/JavaScript/Referencia/Objetos_globales/Object/toString
/es/docs/Referencia_de_JavaScript_1.5:Objetos_globales:Object:unwatch	/es/docs/Web/JavaScript/Referencia/Objetos_globales/Object/unwatch
/es/docs/Referencia_de_JavaScript_1.5:Objetos_globales:Object:watch	/es/docs/Web/JavaScript/Referencia/Objetos_globales/Object/watch
/es/docs/Referencia_de_JavaScript_1.5:Objetos_globales:RegExp	/es/docs/Web/JavaScript/Referencia/Objetos_globales/RegExp
/es/docs/Referencia_de_JavaScript_1.5:Objetos_globales:String	/es/docs/Web/JavaScript/Referencia/Objetos_globales/String
/es/docs/Referencia_de_JavaScript_1.5:Objetos_globales:String:anchor	/es/docs/Web/JavaScript/Referencia/Objetos_globales/String/anchor
/es/docs/Referencia_de_JavaScript_1.5:Objetos_globales:String:big	/es/docs/Web/JavaScript/Referencia/Objetos_globales/String/big
/es/docs/Referencia_de_JavaScript_1.5:Objetos_globales:String:blink	/es/docs/Web/JavaScript/Referencia/Objetos_globales/String/blink
/es/docs/Referencia_de_JavaScript_1.5:Objetos_globales:String:bold	/es/docs/Web/JavaScript/Referencia/Objetos_globales/String/bold
/es/docs/Referencia_de_JavaScript_1.5:Objetos_globales:String:charAt	/es/docs/Web/JavaScript/Referencia/Objetos_globales/String/charAt
/es/docs/Referencia_de_JavaScript_1.5:Objetos_globales:String:charCodeAt	/es/docs/Web/JavaScript/Referencia/Objetos_globales/String/charCodeAt
/es/docs/Referencia_de_JavaScript_1.5:Objetos_globales:String:concat	/es/docs/Web/JavaScript/Referencia/Objetos_globales/String/concat
/es/docs/Referencia_de_JavaScript_1.5:Objetos_globales:String:constructor	/es/docs/Web/JavaScript/Referencia/Objetos_globales/String
/es/docs/Referencia_de_JavaScript_1.5:Objetos_globales:String:fixed	/es/docs/Web/JavaScript/Referencia/Objetos_globales/String/fixed
/es/docs/Referencia_de_JavaScript_1.5:Objetos_globales:String:fromCharCode	/es/docs/Web/JavaScript/Referencia/Objetos_globales/String/fromCharCode
/es/docs/Referencia_de_JavaScript_1.5:Objetos_globales:String:indexOf	/es/docs/Web/JavaScript/Referencia/Objetos_globales/String/indexOf
/es/docs/Referencia_de_JavaScript_1.5:Objetos_globales:String:italics	/es/docs/Web/JavaScript/Referencia/Objetos_globales/String/italics
/es/docs/Referencia_de_JavaScript_1.5:Objetos_globales:String:lastIndexOf	/es/docs/Web/JavaScript/Referencia/Objetos_globales/String/lastIndexOf
/es/docs/Referencia_de_JavaScript_1.5:Objetos_globales:String:length	/es/docs/Web/JavaScript/Referencia/Objetos_globales/String/length
/es/docs/Referencia_de_JavaScript_1.5:Objetos_globales:String:link	/es/docs/Web/JavaScript/Referencia/Objetos_globales/String/link
/es/docs/Referencia_de_JavaScript_1.5:Objetos_globales:String:match	/es/docs/Web/JavaScript/Referencia/Objetos_globales/String/match
/es/docs/Referencia_de_JavaScript_1.5:Objetos_globales:String:prototype	/es/docs/Web/JavaScript/Referencia/Objetos_globales/String/prototype
/es/docs/Referencia_de_JavaScript_1.5:Objetos_globales:String:replace	/es/docs/Web/JavaScript/Referencia/Objetos_globales/String/replace
/es/docs/Referencia_de_JavaScript_1.5:Objetos_globales:String:search	/es/docs/Web/JavaScript/Referencia/Objetos_globales/String/search
/es/docs/Referencia_de_JavaScript_1.5:Objetos_globales:String:slice	/es/docs/Web/JavaScript/Referencia/Objetos_globales/String/slice
/es/docs/Referencia_de_JavaScript_1.5:Objetos_globales:String:small	/es/docs/Web/JavaScript/Referencia/Objetos_globales/String/small
/es/docs/Referencia_de_JavaScript_1.5:Objetos_globales:String:split	/es/docs/Web/JavaScript/Referencia/Objetos_globales/String/split
/es/docs/Referencia_de_JavaScript_1.5:Objetos_globales:String:strike	/es/docs/Web/JavaScript/Referencia/Objetos_globales/String/strike
/es/docs/Referencia_de_JavaScript_1.5:Objetos_globales:String:sub	/es/docs/Web/JavaScript/Referencia/Objetos_globales/String/sub
/es/docs/Referencia_de_JavaScript_1.5:Objetos_globales:String:substr	/es/docs/Web/JavaScript/Referencia/Objetos_globales/String/substr
/es/docs/Referencia_de_JavaScript_1.5:Objetos_globales:String:substring	/es/docs/Web/JavaScript/Referencia/Objetos_globales/String/substring
/es/docs/Referencia_de_JavaScript_1.5:Objetos_globales:String:sup	/es/docs/Web/JavaScript/Referencia/Objetos_globales/String/sup
/es/docs/Referencia_de_JavaScript_1.5:Objetos_globales:String:toLowerCase	/es/docs/Web/JavaScript/Referencia/Objetos_globales/String/toLowerCase
/es/docs/Referencia_de_JavaScript_1.5:Objetos_globales:String:toString	/es/docs/Web/JavaScript/Referencia/Objetos_globales/String/toString
/es/docs/Referencia_de_JavaScript_1.5:Objetos_globales:String:toUpperCase	/es/docs/Web/JavaScript/Referencia/Objetos_globales/String/toUpperCase
/es/docs/Referencia_de_JavaScript_1.5:Objetos_globales:String:valueOf	/es/docs/Web/JavaScript/Referencia/Objetos_globales/String/valueOf
/es/docs/Referencia_de_JavaScript_1.5:Objetos_globlales:Function:arguments	/es/docs/Web/JavaScript/Referencia/Objetos_globales/Function/arguments
/es/docs/Referencia_de_JavaScript_1.5:Operadores	/es/docs/Web/JavaScript/Referencia/Operadores
/es/docs/Referencia_de_JavaScript_1.5:Operadores:Aritméticos	/es/docs/Web/JavaScript/Referencia/Operadores/Aritméticos
/es/docs/Referencia_de_JavaScript_1.5:Operadores:Especiales:function	/es/docs/Web/JavaScript/Referencia/Operadores/function
/es/docs/Referencia_de_JavaScript_1.5:Operadores:Especiales:instanceof	/es/docs/Web/JavaScript/Referencia/Operadores/instanceof
/es/docs/Referencia_de_JavaScript_1.5:Operadores:Especiales:typeof	/es/docs/Web/JavaScript/Referencia/Operadores/typeof
/es/docs/Referencia_de_JavaScript_1.5:Operadores:Especiales:void	/es/docs/Web/JavaScript/Referencia/Operadores/void
/es/docs/Referencia_de_JavaScript_1.5:Operadores:Miembros	/es/docs/Web/JavaScript/Referencia/Operadores/Miembros
/es/docs/Referencia_de_JavaScript_1.5:Operadores:Operadores_especiales:Operador_this	/es/docs/Web/JavaScript/Referencia/Operadores/this
/es/docs/Referencia_de_JavaScript_1.5:Operadores:String	/es/docs/Web/JavaScript/Referencia/Operadores/Aritméticos
/es/docs/Referencia_de_JavaScript_1.5:Palabras_Reservadas	/es/docs/Web/JavaScript/Referencia/Palabras_Reservadas
/es/docs/Referencia_de_JavaScript_1.5:Propiedades_globales	/es/docs/Web/JavaScript/Referencia/Objetos_globales
/es/docs/Referencia_de_JavaScript_1.5:Propiedades_globales:Infinity	/es/docs/Web/JavaScript/Referencia/Objetos_globales/Infinity
/es/docs/Referencia_de_JavaScript_1.5:Propiedades_globales:NaN	/es/docs/Web/JavaScript/Referencia/Objetos_globales/NaN
/es/docs/Referencia_de_JavaScript_1.5:Propiedades_globales:undefined	/es/docs/Web/JavaScript/Referencia/Objetos_globales/undefined
/es/docs/Referencia_de_JavaScript_1.5:Sentencias	/es/docs/Web/JavaScript/Referencia/Sentencias
/es/docs/Referencia_de_JavaScript_1.5:Sentencias:block	/es/docs/Web/JavaScript/Referencia/Sentencias/block
/es/docs/Referencia_de_JavaScript_1.5:Sentencias:break	/es/docs/Web/JavaScript/Referencia/Sentencias/break
/es/docs/Referencia_de_JavaScript_1.5:Sentencias:continue	/es/docs/Web/JavaScript/Referencia/Sentencias/continue
/es/docs/Referencia_de_JavaScript_1.5:Sentencias:do...while	/es/docs/Web/JavaScript/Referencia/Sentencias/do...while
/es/docs/Referencia_de_JavaScript_1.5:Sentencias:for	/es/docs/Web/JavaScript/Referencia/Sentencias/for
/es/docs/Referencia_de_JavaScript_1.5:Sentencias:for...in	/es/docs/Web/JavaScript/Referencia/Sentencias/for...in
/es/docs/Referencia_de_JavaScript_1.5:Sentencias:function	/es/docs/Web/JavaScript/Referencia/Sentencias/function
/es/docs/Referencia_de_JavaScript_1.5:Sentencias:if...else	/es/docs/Web/JavaScript/Referencia/Sentencias/if...else
/es/docs/Referencia_de_JavaScript_1.5:Sentencias:label	/es/docs/Web/JavaScript/Referencia/Sentencias/label
/es/docs/Referencia_de_JavaScript_1.5:Sentencias:return	/es/docs/Web/JavaScript/Referencia/Sentencias/return
/es/docs/Referencia_de_JavaScript_1.5:Sentencias:throw	/es/docs/Web/JavaScript/Referencia/Sentencias/throw
/es/docs/Referencia_de_JavaScript_1.5:Sentencias:try...catch	/es/docs/Web/JavaScript/Referencia/Sentencias/try...catch
/es/docs/Referencia_de_JavaScript_1.5:Sentencias:var	/es/docs/Web/JavaScript/Referencia/Sentencias/var
/es/docs/Referencia_de_JavaScript_1.5:Sentencias:while	/es/docs/Web/JavaScript/Referencia/Sentencias/while
/es/docs/Requerimientos_para_la_compilación_en_BeOS	/es/docs/Mozilla/Developer_guide/Documentación_para_la_compilación/Requerimientos_para_la_compilación_en_BeOS
/es/docs/Requerimientos_para_la_compilación_en_Linux	/es/docs/Mozilla/Developer_guide/Documentación_para_la_compilación/Requerimientos_para_la_compilación_en_Linux
/es/docs/Requerimientos_para_la_compilación_en_Mac_OS_X	/es/docs/Mozilla/Developer_guide/Documentación_para_la_compilación/Requerimientos_para_la_compilación_en_Mac_OS_X
/es/docs/Requerimientos_para_la_compilación_en_OS_2	/es/docs/Mozilla/Developer_guide/Documentación_para_la_compilación/Requerimientos_para_la_compilación_en_OS_2
/es/docs/Requerimientos_para_la_compilación_en_Windows	/es/docs/Mozilla/Developer_guide/Documentación_para_la_compilación/Requerimientos_para_la_compilación_en_Windows
/es/docs/SVG	/es/docs/Web/SVG
/es/docs/SVG/SVG_en_Firefox_1.5	/es/docs/Web/SVG/SVG_en_Firefox_1.5
/es/docs/SVG/Tutorial	/es/docs/Web/SVG/Tutorial
/es/docs/SVG/Tutorial/Getting_Started	/es/docs/Web/SVG/Tutorial/Getting_Started
/es/docs/SVG:SVG_en_Firefox_1.5	/es/docs/Web/SVG/SVG_en_Firefox_1.5
/es/docs/SVG_In_HTML_Introduction	/es/docs/Web/SVG/Tutorial/SVG_In_HTML_Introduction
/es/docs/Screening_duplicate_bugs	/es/docs/QA/Screening_duplicate_bugs
/es/docs/Secciones_y_contornos_de_un_documento_HTML5	/es/docs/Sections_and_Outlines_of_an_HTML5_document
/es/docs/Secciones_y_esquema_de_un_documento_HTML_5	/es/docs/Sections_and_Outlines_of_an_HTML5_document
/es/docs/Social_API-redirect-1	/es/docs/Social_API
/es/docs/Social_API-redirect-2	/es/docs/Social_API
/es/docs/Social_API/Glossary-redirect-1	/es/docs/Social_API/Glossary
/es/docs/Social_API/Glossary-redirect-2	/es/docs/Social_API/Glossary
/es/docs/Social_API/Guide-redirect-1	/es/docs/Social_API/Guide
/es/docs/Temas:Comunidad	/es/docs/Temas/Comunidad
/es/docs/The_geo_microformat	/es/docs/El_microformato_geo
/es/docs/Theme_changes_in_Firefox_3	/es/docs/El_colector_de_ciclo_XPCOM
/es/docs/Transformando_XML_con_XSLT	/es/docs/Web/XSLT/Transformando_XML_con_XSLT
/es/docs/Tutorial_de_Canvas:Transformaciones	/es/docs/Tutorial_de_Canvas/Transformaciones
/es/docs/Tutorial_de_XUL/Creando_Dialogos	/es/docs/Tutorial_de_XUL/Creando_Diálogos
/es/docs/Tutorial_de_XUL/Indicadores_de_progreso	/es/docs/Tutorial_de_XUL/Medidores_de_progreso
/es/docs/Tutorial_de_XUL:Creando_Dialogos	/es/docs/Tutorial_de_XUL/Creando_Diálogos
/es/docs/Tutorial_de_XUL:El_modelo_de_caja	/es/docs/Tutorial_de_XUL/El_modelo_de_caja
/es/docs/Tutorial_de_XUL:Indicadores_de_progreso	/es/docs/Tutorial_de_XUL/Medidores_de_progreso
/es/docs/Usando_audio_y_video_con_HTML5	/es/docs/Web/HTML/Usando_audio_y_video_con_HTML5
/es/docs/Usando_audio_y_video_en_Firefox	/es/docs/Web/HTML/Usando_audio_y_video_con_HTML5
/es/docs/Usando_módulos_de_código_JavaScript	/es/docs/JavaScript_code_modules/Using
/es/docs/Usar_audio_y_vídeo_en_Firefox	/es/docs/Web/HTML/Usando_audio_y_video_con_HTML5
/es/docs/Usar_gradientes	/es/docs/CSS/Using_CSS_gradients
/es/docs/Usar_la_Geolocalización	/es/docs/WebAPI/Using_geolocation
/es/docs/Using_files_from_web_applications	/es/docs/Web/API/File/Using_files_from_web_applications
/es/docs/Using_geolocation	/es/docs/WebAPI/Using_geolocation
/es/docs/Uso_de_URL_como_valor_de_la_propiedad_cursor	/es/docs/Web/CSS/cursor/Uso_de_URL_como_valor_de_la_propiedad_cursor
/es/docs/Vigilando_complementos	/es/docs/Vigilar_plugins
/es/docs/Vigilando_descargas	/es/docs/Vigilar_descargas
/es/docs/Vigilando_plugins	/es/docs/Vigilar_plugins
/es/docs/Web/API/Apps.checkInstalled	/es/docs/Web/API/DOMApplicationsRegistry/checkInstalled
/es/docs/Web/API/Apps.getInstalled	/es/docs/Web/API/DOMApplicationsRegistry/getInstalled
/es/docs/Web/API/Apps.install	/es/docs/Web/API/DOMApplicationsRegistry/install
/es/docs/Web/API/Apps.installPackage	/es/docs/Web/API/DOMApplicationsRegistry/installPackage
/es/docs/Web/API/BatteryManager.charging	/es/docs/Web/API/BatteryManager/charging
/es/docs/Web/API/BatteryManager.chargingTime	/es/docs/Web/API/BatteryManager/chargingTime
/es/docs/Web/API/BatteryManager.dischargingTime	/es/docs/Web/API/BatteryManager/dischargingTime
/es/docs/Web/API/BatteryManager.level	/es/docs/Web/API/BatteryManager/level
/es/docs/Web/API/BatteryManager.onchargingchange	/es/docs/Web/API/BatteryManager/onchargingchange
/es/docs/Web/API/BatteryManager.onlevelchange	/es/docs/Web/API/BatteryManager/onlevelchange
/es/docs/Web/API/Blob.Blob	/es/docs/Web/API/Blob/Blob
/es/docs/Web/API/CSSStyleSheet.insertRule	/es/docs/Web/API/CSSStyleSheet/insertRule
/es/docs/Web/API/CameraCapabilities.maxExposureCompensation	/es/docs/Web/API/CameraCapabilities/maxExposureCompensation
/es/docs/Web/API/CameraCapabilities.maxFocusAreas	/es/docs/Web/API/CameraCapabilities/maxFocusAreas
/es/docs/Web/API/Constraint_validation/invalid_event	/es/docs/Web/API/HTMLInputElement/invalid_event
/es/docs/Web/API/Coordinates	/es/docs/Web/API/GeolocationCoordinates
/es/docs/Web/API/Coordinates/latitude	/es/docs/Web/API/GeolocationCoordinates/latitude
/es/docs/Web/API/Document/activeElement	/es/docs/Web/API/DocumentOrShadowRoot/activeElement
/es/docs/Web/API/Document/elementFromPoint	/es/docs/Web/API/DocumentOrShadowRoot/elementFromPoint
/es/docs/Web/API/Document/firstChild	/es/docs/Web/API/Node.firstChild
/es/docs/Web/API/Geolocalización	/es/docs/Web/API/Geolocation
/es/docs/Web/API/Geolocation.clearWatch	/es/docs/Web/API/Geolocation/clearWatch
/es/docs/Web/API/Geolocation.getCurrentPosition	/es/docs/Web/API/Geolocation/getCurrentPosition
/es/docs/Web/API/Geolocation.watchPosition	/es/docs/Web/API/Geolocation/watchPosition
/es/docs/Web/API/HTMLElement/invalid_event	/es/docs/Web/API/HTMLInputElement/invalid_event
/es/docs/Web/API/IDBObjectStore.add	/es/docs/Web/API/IDBObjectStore/add
/es/docs/Web/API/Navigator.getUserMedia	/es/docs/Web/API/Navigator/getUserMedia
/es/docs/Web/API/Node.nextSibling	/es/docs/Web/API/Node/nextSibling
/es/docs/Web/API/Node/firstChild	/es/docs/Web/API/Node.firstChild
/es/docs/Web/API/Position	/es/docs/Web/API/GeolocationPosition
/es/docs/Web/API/WebGL_API/Animating_objects_with_WebGL	/es/docs/Web/API/WebGL_API/Tutorial/Animating_objects_with_WebGL
/es/docs/Web/API/WebGL_API/Getting_started_with_WebGL	/es/docs/Web/API/WebGL_API/Tutorial/Getting_started_with_WebGL
/es/docs/Web/API/Window.clearTimeout	/es/docs/Web/API/WindowTimers/clearTimeout
/es/docs/Web/API/Window.navigator	/es/docs/Web/API/Window/navigator
/es/docs/Web/API/Window.onbeforeunload	/es/docs/Web/API/WindowEventHandlers/onbeforeunload
/es/docs/Web/API/Window.setTimeout	/es/docs/Web/API/WindowTimers/setTimeout
/es/docs/Web/API/WindowBase64.atob	/es/docs/Web/API/WindowBase64/atob
/es/docs/Web/API/event.defaultPrevented	/es/docs/Web/API/Event/defaultPrevented
/es/docs/Web/API/event.which	/es/docs/Web/API/KeyboardEvent/which
/es/docs/Web/Aplicaciones/Arquitectura_de_aplicaciones	/es/docs/Web/Aplicaciones/Build/Arquitectura_de_aplicaciones
/es/docs/Web/Aplicaciones/Comenzar	/es/docs/Web/Aplicaciones/Comenzando_aplicaciones
/es/docs/Web/Aplicaciones/Comenzar_con_la_creación_de_aplicaciones	/es/docs/Web/Aplicaciones/Comenzando_aplicaciones
/es/docs/Web/Aplicaciones/Developing	/es/docs/Web/Aplicaciones/Build
/es/docs/Web/Aplicaciones/Developing/Manifest	/es/docs/Web/Aplicaciones/Build/Manifest
/es/docs/Web/Aplicaciones/Iniciarse	/es/docs/Web/Aplicaciones/Comenzando_aplicaciones
/es/docs/Web/Aplicaciones/Progressive	/es/docs/Web/Progressive_web_apps
/es/docs/Web/Aplicaciones/Progressive/Introduction	/es/docs/Web/Progressive_web_apps/Introduction
/es/docs/Web/Apps/Design	/es/docs/Web/Aplicaciones/Design
/es/docs/Web/Apps/Design/Navegacion_Adaptativa	/es/docs/Web/Aplicaciones/Design/Navegacion_Adaptativa
/es/docs/Web/Apps/Design/Planning_your_app	/es/docs/Web/Aplicaciones/Design/Planning_your_app
/es/docs/Web/Apps/Developing	/es/docs/Web/Aplicaciones/Build
/es/docs/Web/Apps/Developing/Manifest/Manifest	/es/docs/Web/Aplicaciones/Build/Manifest
/es/docs/Web/Apps/Games	/es/docs/Web/Aplicaciones/Games
/es/docs/Web/Apps/Games/Consideraciones_especiales	/es/docs/Web/Aplicaciones/Games/Consideraciones_especiales
/es/docs/Web/Apps/Quickstart	/es/docs/Web/Aplicaciones/Quickstart
/es/docs/Web/Apps/Quickstart/Design	/es/docs/Web/Aplicaciones/Quickstart/Design
/es/docs/Web/Apps/Quickstart/Design/Concept_A_great_app	/es/docs/Web/Aplicaciones/Quickstart/Design/Concept_A_great_app
/es/docs/Web/Apps/Quickstart/Design/Pautas_UI	/es/docs/Web/Aplicaciones/Quickstart/Design/Pautas_UI
/es/docs/Web/Apps/Quickstart/Design/Principios_de_diseño	/es/docs/Web/Aplicaciones/Quickstart/Design/Principios_de_diseño
/es/docs/Web/CSS/-moz-appearance	/es/docs/Web/CSS/appearance
/es/docs/Web/CSS/Child_selectors	/es/docs/Web/CSS/Child_combinator
/es/docs/Web/CSS/Como_iniciar/Porqué_usar_CSS	/es/docs/Web/CSS/Como_iniciar/Por_que_usar_CSS
/es/docs/Web/CSS/Consultas_multimedia	/es/docs/CSS/Media_queries
/es/docs/Web/CSS/Descendant_selectors	/es/docs/Web/CSS/Descendant_combinator
/es/docs/Web/CSS/Getting_Started	/es/docs/Web/CSS/Comenzando_(tutorial_CSS)
/es/docs/Web/CSS/Introducción/Content	/es/docs/Learn/CSS/Sábercomo/Generated_content
/es/docs/Web/CSS/Referencia_CSS/Extensiones_CSS_Mozilla	/es/docs/Web/CSS/Mozilla_Extensions
/es/docs/Web/CSS/Referencia_CSS/Extensiones_Mozilla	/es/docs/Web/CSS/Mozilla_Extensions
/es/docs/Web/CSS/Referencia_CSS/background-blend-mode	/es/docs/Web/CSS/background-blend-mode
/es/docs/Web/CSS/Usando_animaciones_CSS	/es/docs/Web/CSS/CSS_Animations/Usando_animaciones_CSS
/es/docs/Web/CSS/Using_CSS_transforms	/es/docs/Web/CSS/CSS_Transforms/Using_CSS_transforms
/es/docs/Web/CSS/Using_CSS_variables	/es/docs/Web/CSS/Using_CSS_custom_properties
/es/docs/Web/CSS/after	/es/docs/Web/CSS/::after
/es/docs/Web/CSS/animacion-iteracion-cuenta	/es/docs/Web/CSS/animation-iteration-count
/es/docs/Web/CSS/animacion-nombre	/es/docs/Web/CSS/animation-name
/es/docs/Web/CSS/attr	/es/docs/Web/CSS/attr()
/es/docs/Web/CSS/before	/es/docs/Web/CSS/::before
/es/docs/Web/CSS/calc	/es/docs/Web/CSS/calc()
/es/docs/Web/CSS/capacidad_de_animacion_de_propiedades_CSS	/es/docs/Web/CSS
/es/docs/Web/CSS/computed_value	/es/docs/Web/CSS/Valor_calculado
/es/docs/Web/CSS/env	/es/docs/Web/CSS/env()
/es/docs/Web/CSS/filter-function/blur	/es/docs/Web/CSS/filter-function/blur()
/es/docs/Web/CSS/filter-function/brightness	/es/docs/Web/CSS/filter-function/brightness()
/es/docs/Web/CSS/filtro	/es/docs/Web/CSS/filter
/es/docs/Web/CSS/kerning	/en-US/docs/Web/CSS/font-kerning
/es/docs/Web/CSS/linear-gradient	/es/docs/Web/CSS/linear-gradient()
/es/docs/Web/CSS/min	/es/docs/Web/CSS/min()
/es/docs/Web/CSS/minmax	/es/docs/Web/CSS/minmax()
/es/docs/Web/CSS/none	/es/docs/Web/CSS/float
/es/docs/Web/CSS/padding_paspartu	/es/docs/Web/CSS/padding
/es/docs/Web/CSS/radial-gradient	/es/docs/Web/CSS/radial-gradient()
/es/docs/Web/CSS/repeat	/es/docs/Web/CSS/repeat()
/es/docs/Web/CSS/transform-function/rotate	/es/docs/Web/CSS/transform-function/rotate()
/es/docs/Web/CSS/transform-function/rotate3d	/es/docs/Web/CSS/transform-function/rotate3d()
/es/docs/Web/CSS/transform-function/scale	/es/docs/Web/CSS/transform-function/scale()
/es/docs/Web/CSS/transform-function/translate	/es/docs/Web/CSS/transform-function/translate()
/es/docs/Web/CSS/transform-function/translateY	/es/docs/Web/CSS/transform-function/translateY()
/es/docs/Web/CSS/transform-function/translateZ	/es/docs/Web/CSS/transform-function/translateZ()
/es/docs/Web/CSS/var	/es/docs/Web/CSS/var()
/es/docs/Web/Events/canplay	/es/docs/Web/API/HTMLMediaElement/canplay_event
/es/docs/Web/Events/click	/es/docs/Web/API/Element/click_event
/es/docs/Web/Events/close_websocket	/es/docs/Web/API/WebSocket/close_event
/es/docs/Web/Events/dragover	/es/docs/Web/API/Document/dragover_event
/es/docs/Web/Events/hashchange	/es/docs/Web/API/Window/hashchange_event
/es/docs/Web/Events/keydown	/es/docs/Web/API/Document/keydown_event
/es/docs/Web/Events/mousedown	/es/docs/Web/API/Element/mousedown_event
/es/docs/Web/Events/offline	/es/docs/Web/API/Window/offline_event
/es/docs/Web/Events/scroll	/es/docs/Web/API/Document/scroll_event
/es/docs/Web/Events/tecla	/es/docs/Web/API/Document/keyup_event
/es/docs/Web/Events/timeupdate	/es/docs/Web/API/HTMLMediaElement/timeupdate_event
/es/docs/Web/Events/timeupdate_event	/es/docs/Web/HTML/Elemento/audio/timeupdate_event
/es/docs/Web/Events/wheel	/es/docs/Web/API/Element/wheel_event
/es/docs/Web/Guide/CSS	/es/docs/Learn/CSS
/es/docs/Web/Guide/CSS/Cajas_flexibles	/es/docs/Web/CSS/CSS_Flexible_Box_Layout/Usando_las_cajas_flexibles_CSS
/es/docs/Web/Guide/DOM/Events/Orientation_and_motion_data_explained	/es/docs/Web/Guide/API/DOM/Events/Orientation_and_motion_data_explained/Orientation_and_motion_data_explained
/es/docs/Web/Guide/HTML	/es/docs/Learn/HTML
/es/docs/Web/Guide/HTML/Forms	/es/docs/Learn/HTML/Forms
/es/docs/Web/Guide/HTML/Forms/How_to_structure_an_HTML_form	/es/docs/Learn/HTML/Forms/How_to_structure_an_HTML_form
/es/docs/Web/Guide/HTML/Forms/My_first_HTML_form	/es/docs/Learn/HTML/Forms/Your_first_HTML_form
/es/docs/Web/Guide/HTML/Forms/Sending_and_retrieving_form_data	/es/docs/Learn/HTML/Forms/Sending_and_retrieving_form_data
/es/docs/Web/Guide/HTML/Forms/Styling_HTML_forms	/es/docs/Learn/HTML/Forms/Styling_HTML_forms
/es/docs/Web/Guide/HTML/Introduction_alhtml	/es/docs/Learn/HTML/Introduccion_a_HTML
/es/docs/Web/HTML/Elemento/<data>	/es/docs/Web/HTML/Elemento/data
/es/docs/Web/HTML/Elemento/Audio2	/es/docs/Web/HTML/Elemento/audio
/es/docs/Web/HTML/Elemento/Progreso	/es/docs/Web/HTML/Elemento/progress
/es/docs/Web/HTML/Elemento/etiqueta	/es/docs/Web/HTML/Elemento/label
/es/docs/Web/HTML/Elemento/h2	/es/docs/Web/HTML/Elemento/Elementos_títulos
/es/docs/Web/HTML/Elemento/h3	/es/docs/Web/HTML/Elemento/Elementos_títulos
/es/docs/Web/HTML/Elemento/h4	/es/docs/Web/HTML/Elemento/Elementos_títulos
/es/docs/Web/HTML/Elemento/h5	/es/docs/Web/HTML/Elemento/Elementos_títulos
/es/docs/Web/HTML/Elemento/h6	/es/docs/Web/HTML/Elemento/Elementos_títulos
/es/docs/Web/HTML/Elemento/preformato	/es/docs/Web/HTML/Elemento/pre
/es/docs/Web/HTML/Elemento/video/canplay_event	/es/docs/Web/API/HTMLMediaElement/canplay_event
/es/docs/Web/HTML/Elemento/video/timeupdate_event	/es/docs/Web/API/HTMLMediaElement/timeupdate_event
/es/docs/Web/HTML/Gestión_del_foco_en_HTML	/es/docs/Web/API/Document/hasFocus
/es/docs/Web/HTTP/Basics_of_HTTP/MIME_types/Lista_completa_de_tipos_MIME	/es/docs/Web/HTTP/Basics_of_HTTP/MIME_types/Common_types
/es/docs/Web/JavaScript/Guide/AcercaDe	/es/docs/Web/JavaScript/Guide/Introducción
/es/docs/Web/JavaScript/Guide/Closures	/es/docs/Web/JavaScript/Closures
/es/docs/Web/JavaScript/Guide/Inheritance_Revisited	/es/docs/Web/JavaScript/Inheritance_and_the_prototype_chain
/es/docs/Web/JavaScript/Guide/JavaScript_Overview	/es/docs/Web/JavaScript/Guide/Introducción
/es/docs/Web/JavaScript/Guide/Obsolete_Pages	/es/docs/Web/JavaScript/Guide
/es/docs/Web/JavaScript/Guide/Obsolete_Pages/Guía_JavaScript_1.5	/es/docs/Web/JavaScript/Guide
/es/docs/Web/JavaScript/Guide/Obsolete_Pages/Guía_JavaScript_1.5/Acerca_de_esta_guía	/es/docs/Web/JavaScript/Guide/Introducción
/es/docs/Web/JavaScript/Guide/Obsolete_Pages/Guía_JavaScript_1.5/Concepto_de_JavaScript	/es/docs/Web/JavaScript/Guide/Introducción
/es/docs/Web/JavaScript/Guide/Obsolete_Pages/Guía_JavaScript_1.5/Constantes	/es/docs/Web/JavaScript/Referencia/Sentencias/const
/es/docs/Web/JavaScript/Guide/Obsolete_Pages/Guía_JavaScript_1.5/Constructores_más_flexibles	/es/docs/Web/JavaScript/Guide/Details_of_the_Object_Model#Constructores_mas_flexibles
/es/docs/Web/JavaScript/Guide/Obsolete_Pages/Guía_JavaScript_1.5/Crear_nuevos_objetos	/es/docs/Web/JavaScript/Guide/Trabajando_con_objectos#Creando_nuevos_objetos
/es/docs/Web/JavaScript/Guide/Obsolete_Pages/Guía_JavaScript_1.5/Crear_nuevos_objetos/Borrando_propiedades	/es/docs/Web/JavaScript/Guide/Trabajando_con_objectos#Eliminando_propiedades
/es/docs/Web/JavaScript/Guide/Obsolete_Pages/Guía_JavaScript_1.5/Crear_nuevos_objetos/Definiendo_las_funciones_get_y_set	/es/docs/Web/JavaScript/Guide/Trabajando_con_objectos#Definiendo_getters_y_setters
/es/docs/Web/JavaScript/Guide/Obsolete_Pages/Guía_JavaScript_1.5/Crear_nuevos_objetos/Definiendo_los_métodos	/es/docs/Web/JavaScript/Guide/Trabajando_con_objectos#Definiendo_los_m.C3.A9todos
/es/docs/Web/JavaScript/Guide/Obsolete_Pages/Guía_JavaScript_1.5/Crear_nuevos_objetos/Definiendo_propiedades_para_un_tipo_de_objeto	/es/docs/Web/JavaScript/Guide/Trabajando_con_objectos#Definici.C3.B3n_de_las_propiedades_de_un_tipo_de_objeto
/es/docs/Web/JavaScript/Guide/Obsolete_Pages/Guía_JavaScript_1.5/Crear_nuevos_objetos/Indexando_las_propiedades_del_objeto	/es/docs/Web/JavaScript/Guide/Trabajando_con_objectos#Propiedades_del_objeto_indexado
/es/docs/Web/JavaScript/Guide/Obsolete_Pages/Guía_JavaScript_1.5/Crear_nuevos_objetos/Usando_this_para_referirse_al_objeto	/es/docs/Web/JavaScript/Guide/Trabajando_con_objectos#Usando_this_para_las_referencias_a_objetos
/es/docs/Web/JavaScript/Guide/Obsolete_Pages/Guía_JavaScript_1.5/Crear_nuevos_objetos/Usando_una_función_constructora	/es/docs/Web/JavaScript/Guide/Trabajando_con_objectos#Usando_una_funci.C3.B3n_constructora
/es/docs/Web/JavaScript/Guide/Obsolete_Pages/Guía_JavaScript_1.5/Crear_nuevos_objetos/Using_Object_Initializers	/es/docs/Web/JavaScript/Guide/Trabajando_con_objectos#El_uso_de_inicializadores_de_objeto
/es/docs/Web/JavaScript/Guide/Obsolete_Pages/Guía_JavaScript_1.5/Crear_nuevos_objetos/Utilizando_Objetos_Iniciadores	/es/docs/Web/JavaScript/Guide/Trabajando_con_objectos#El_uso_de_inicializadores_de_objeto
/es/docs/Web/JavaScript/Guide/Obsolete_Pages/Guía_JavaScript_1.5/Crear_una_expresión_regular	/es/docs/Web/JavaScript/Guide/Regular_Expressions
/es/docs/Web/JavaScript/Guide/Obsolete_Pages/Guía_JavaScript_1.5/Definiendo_Funciones	/es/docs/Web/JavaScript/Guide/Funciones
/es/docs/Web/JavaScript/Guide/Obsolete_Pages/Guía_JavaScript_1.5/El_ejemplo_Empleado	/es/docs/Web/JavaScript/Guide/Details_of_the_Object_Model#Ejemplo.3A_employee
/es/docs/Web/JavaScript/Guide/Obsolete_Pages/Guía_JavaScript_1.5/El_ejemplo_Employee	/es/docs/Web/JavaScript/Guide/Details_of_the_Object_Model#Ejemplo.3A_employee
/es/docs/Web/JavaScript/Guide/Obsolete_Pages/Guía_JavaScript_1.5/El_ejemplo_Employee/Creando_la_jerarquía	/es/docs/Web/JavaScript/Guide/Details_of_the_Object_Model#Creacion_de_la_jerarquia
/es/docs/Web/JavaScript/Guide/Obsolete_Pages/Guía_JavaScript_1.5/El_ejemplo_Employee/Propiedades_de_objetos	/es/docs/Web/JavaScript/Guide/Details_of_the_Object_Model#Propiedades_de_objetos
/es/docs/Web/JavaScript/Guide/Obsolete_Pages/Guía_JavaScript_1.5/El_ejemplo_Employee/Propiedades_de_objetos/Añadiendo_propiedades	/es/docs/Web/JavaScript/Guide/Details_of_the_Object_Model#A.C3.B1adir_propiedades
/es/docs/Web/JavaScript/Guide/Obsolete_Pages/Guía_JavaScript_1.5/El_ejemplo_Employee/Propiedades_de_objetos/Heredando_las_propiedades	/es/docs/Web/JavaScript/Guide/Details_of_the_Object_Model#Herencia_de_propiedades
/es/docs/Web/JavaScript/Guide/Obsolete_Pages/Guía_JavaScript_1.5/Escribir_un_patrón_de_expresión_regular	/es/docs/Web/JavaScript/Guide/Regular_Expressions
/es/docs/Web/JavaScript/Guide/Obsolete_Pages/Guía_JavaScript_1.5/Excepción_del_DOM	/es/docs/Web/API/DOMException
/es/docs/Web/JavaScript/Guide/Obsolete_Pages/Guía_JavaScript_1.5/Expresiones	/es/docs/Web/JavaScript/Guide/Expressions_and_Operators
/es/docs/Web/JavaScript/Guide/Obsolete_Pages/Guía_JavaScript_1.5/Expresiones_Regulares	/es/docs/Web/JavaScript/Guide/Regular_Expressions
/es/docs/Web/JavaScript/Guide/Obsolete_Pages/Guía_JavaScript_1.5/Expresiones_y_operadores	/es/docs/Web/JavaScript/Guide/Expressions_and_Operators
/es/docs/Web/JavaScript/Guide/Obsolete_Pages/Guía_JavaScript_1.5/Funciones_Number_y_String	/es/docs/Web/JavaScript/Guide/Funciones#Number_and_String_functions
/es/docs/Web/JavaScript/Guide/Obsolete_Pages/Guía_JavaScript_1.5/Funciones_escape_y_unescape	/es/docs/Web/JavaScript/Guide/Funciones#escape_and_unescape_functions(Obsoleted_above_JavaScript_1.5)
/es/docs/Web/JavaScript/Guide/Obsolete_Pages/Guía_JavaScript_1.5/Funciones_parseInt_y_parseFloat	/es/docs/Web/JavaScript/Guide/Funciones#parseInt_and_parseFloat_functions
/es/docs/Web/JavaScript/Guide/Obsolete_Pages/Guía_JavaScript_1.5/Funciones_predefinidas	/es/docs/Web/JavaScript/Guide/Funciones#Predefined_functions
/es/docs/Web/JavaScript/Guide/Obsolete_Pages/Guía_JavaScript_1.5/Funciones_predefinidas/Función_eval	/es/docs/Web/JavaScript/Guide/Funciones#eval_Function
/es/docs/Web/JavaScript/Guide/Obsolete_Pages/Guía_JavaScript_1.5/Funciones_predefinidas/Función_isFinite	/es/docs/Web/JavaScript/Guide/Funciones#isFinite_function
/es/docs/Web/JavaScript/Guide/Obsolete_Pages/Guía_JavaScript_1.5/Funciones_predefinidas/Función_isNaN	/es/docs/Web/JavaScript/Guide/Funciones#isNaN_function
/es/docs/Web/JavaScript/Guide/Obsolete_Pages/Guía_JavaScript_1.5/Lenguajes_basados_en_clases_frente_a_basados_en_prototipos	/es/docs/Web/JavaScript/Guide/Details_of_the_Object_Model
/es/docs/Web/JavaScript/Guide/Obsolete_Pages/Guía_JavaScript_1.5/Literales	/es/docs/Web/JavaScript/Guide/Grammar_and_types#Literales
/es/docs/Web/JavaScript/Guide/Obsolete_Pages/Guía_JavaScript_1.5/Llamando_Funciones	/es/docs/Web/JavaScript/Guide/Funciones#Llamando_funciones
/es/docs/Web/JavaScript/Guide/Obsolete_Pages/Guía_JavaScript_1.5/Más_sobre_la_herencia_de_propiedades	/es/docs/Web/JavaScript/Guide/Details_of_the_Object_Model#Mas_sobre_herencia_de_propiedades
/es/docs/Web/JavaScript/Guide/Obsolete_Pages/Guía_JavaScript_1.5/Más_sobre_la_herencia_de_propiedades/Determinando_relaciones_de_instancia	/es/docs/Web/JavaScript/Guide/Details_of_the_Object_Model#Como_determinar_las_relaciones_entre_instancias
/es/docs/Web/JavaScript/Guide/Obsolete_Pages/Guía_JavaScript_1.5/Más_sobre_la_herencia_de_propiedades/Herencia_no_múltiple	/es/docs/Web/JavaScript/Guide/Details_of_the_Object_Model#No_existe_herencia_multiple
/es/docs/Web/JavaScript/Guide/Obsolete_Pages/Guía_JavaScript_1.5/Más_sobre_la_herencia_de_propiedades/Información_global_en_los_constructores	/es/docs/Web/JavaScript/Guide/Details_of_the_Object_Model#Informacion_global_en_los_constructores
/es/docs/Web/JavaScript/Guide/Obsolete_Pages/Guía_JavaScript_1.5/Más_sobre_la_herencia_de_propiedades/Valores_locales_frente_a_los_heredados	/es/docs/Web/JavaScript/Guide/Details_of_the_Object_Model#Valores_locales_frente_a_valores_heredados
/es/docs/Web/JavaScript/Guide/Obsolete_Pages/Guía_JavaScript_1.5/Objetos_base_predefinidos	/es/docs/Web/JavaScript/Referencia
/es/docs/Web/JavaScript/Guide/Obsolete_Pages/Guía_JavaScript_1.5/Objetos_base_predefinidos/Objeto_Array	/es/docs/Web/JavaScript/Referencia/Objetos_globales/Array
/es/docs/Web/JavaScript/Guide/Obsolete_Pages/Guía_JavaScript_1.5/Objetos_base_predefinidos/Objeto_Boolean	/es/docs/Web/JavaScript/Referencia/Objetos_globales/Boolean
/es/docs/Web/JavaScript/Guide/Obsolete_Pages/Guía_JavaScript_1.5/Objetos_base_predefinidos/Objeto_Date	/es/docs/Web/JavaScript/Referencia/Objetos_globales/Date
/es/docs/Web/JavaScript/Guide/Obsolete_Pages/Guía_JavaScript_1.5/Objetos_base_predefinidos/Objeto_Function	/es/docs/Web/JavaScript/Referencia/Objetos_globales/Function
/es/docs/Web/JavaScript/Guide/Obsolete_Pages/Guía_JavaScript_1.5/Objetos_base_predefinidos/Objeto_Math	/es/docs/Web/JavaScript/Referencia/Objetos_globales/Math
/es/docs/Web/JavaScript/Guide/Obsolete_Pages/Guía_JavaScript_1.5/Objetos_base_predefinidos/Objeto_Number	/es/docs/Web/JavaScript/Referencia/Objetos_globales/Number
/es/docs/Web/JavaScript/Guide/Obsolete_Pages/Guía_JavaScript_1.5/Objetos_base_predefinidos/Objeto_RegExp	/es/docs/Web/JavaScript/Referencia/Objetos_globales/RegExp
/es/docs/Web/JavaScript/Guide/Obsolete_Pages/Guía_JavaScript_1.5/Objetos_base_predefinidos/Objeto_String	/es/docs/Web/JavaScript/Referencia/Objetos_globales/String
/es/docs/Web/JavaScript/Guide/Obsolete_Pages/Guía_JavaScript_1.5/Objetos_y_propiedades	/es/docs/Web/JavaScript/Guide/Trabajando_con_objectos#Objetos_y_propiedades
/es/docs/Web/JavaScript/Guide/Obsolete_Pages/Guía_JavaScript_1.5/Operadores	/es/docs/Web/JavaScript/Guide/Expressions_and_Operators#Operadores
/es/docs/Web/JavaScript/Guide/Obsolete_Pages/Guía_JavaScript_1.5/Operadores/Operadores_aritméticos	/es/docs/Web/JavaScript/Guide/Expressions_and_Operators#Operadores_aritm.C3.A9ticos
/es/docs/Web/JavaScript/Guide/Obsolete_Pages/Guía_JavaScript_1.5/Operadores/Operadores_de_asignación	/es/docs/Web/JavaScript/Guide/Expressions_and_Operators#Operadores_de_asignaci.C3.B3n
/es/docs/Web/JavaScript/Guide/Obsolete_Pages/Guía_JavaScript_1.5/Operadores/Operadores_de_cadenas_de_caracteres_(string)	/es/docs/Web/JavaScript/Guide/Expressions_and_Operators#String_operators
/es/docs/Web/JavaScript/Guide/Obsolete_Pages/Guía_JavaScript_1.5/Operadores/Operadores_de_comparación	/es/docs/Web/JavaScript/Guide/Expressions_and_Operators#Operadores_de_comparaci.C3.B3n
/es/docs/Web/JavaScript/Guide/Obsolete_Pages/Guía_JavaScript_1.5/Operadores/Operadores_especiales	/es/docs/Web/JavaScript/Guide/Expressions_and_Operators#Special_operators
/es/docs/Web/JavaScript/Guide/Obsolete_Pages/Guía_JavaScript_1.5/Operadores/Operadores_lógicos	/es/docs/Web/JavaScript/Guide/Expressions_and_Operators#Operadores_l.C3.B3gicos
/es/docs/Web/JavaScript/Guide/Obsolete_Pages/Guía_JavaScript_1.5/Operadores/Operadores_sobre_bits	/es/docs/Web/JavaScript/Guide/Expressions_and_Operators#Operadores_Bit-a-bit
/es/docs/Web/JavaScript/Guide/Obsolete_Pages/Guía_JavaScript_1.5/Predefined_Functions	/es/docs/Web/JavaScript/Referencia/Objetos_globales
/es/docs/Web/JavaScript/Guide/Obsolete_Pages/Guía_JavaScript_1.5/Predefined_Functions/eval_Function	/es/docs/Web/JavaScript/Referencia/Objetos_globales/eval
/es/docs/Web/JavaScript/Guide/Obsolete_Pages/Guía_JavaScript_1.5/Sentencia_condicional	/es/docs/Web/JavaScript/Guide/Control_de_flujo_y_manejo_de_errores#Condicionales
/es/docs/Web/JavaScript/Guide/Obsolete_Pages/Guía_JavaScript_1.5/Sentencia_de_bloque	/es/docs/Web/JavaScript/Referencia/Sentencias/block
/es/docs/Web/JavaScript/Guide/Obsolete_Pages/Guía_JavaScript_1.5/Sentencias_de_bucle	/es/docs/Web/JavaScript/Guide/Loops_and_iteration
/es/docs/Web/JavaScript/Guide/Obsolete_Pages/Guía_JavaScript_1.5/Sentencias_de_manejo_de_excepciones	/es/docs/Web/JavaScript/Guide/Control_de_flujo_y_manejo_de_errores#Utilizing_Error_objects
/es/docs/Web/JavaScript/Guide/Obsolete_Pages/Guía_JavaScript_1.5/Sentencias_de_manejo_de_excepciones/throw	/es/docs/Web/JavaScript/Guide/Control_de_flujo_y_manejo_de_errores#throw_statement
/es/docs/Web/JavaScript/Guide/Obsolete_Pages/Guía_JavaScript_1.5/Sentencias_de_manejo_de_excepciones/try...catch	/es/docs/Web/JavaScript/Guide/Control_de_flujo_y_manejo_de_errores#try...catch_statement
/es/docs/Web/JavaScript/Guide/Obsolete_Pages/Guía_JavaScript_1.5/Sentencias_de_manipulación_de_objetos	/es/docs/Web/JavaScript/Guide
/es/docs/Web/JavaScript/Guide/Obsolete_Pages/Guía_JavaScript_1.5/Sentencias_para_comentarios	/es/docs/Web/JavaScript/Guide
/es/docs/Web/JavaScript/Guide/Obsolete_Pages/Guía_JavaScript_1.5/Trabajar_con_expresiones_regulares	/es/docs/Web/JavaScript/Guide/Regular_Expressions
/es/docs/Web/JavaScript/Guide/Obsolete_Pages/Guía_JavaScript_1.5/Trabajar_con_expresiones_regulares/Ejecutar_una_busqueda_global,_discriminar_mayúsculas_y_minúsculas_y_considerar_entrada_multilínea	/es/docs/Web/JavaScript/Guide/Regular_Expressions
/es/docs/Web/JavaScript/Guide/Obsolete_Pages/Guía_JavaScript_1.5/Trabajar_con_expresiones_regulares/Ejecutar_una_busqueda_global,_ignorar_mayusculas_minusculas,_y_considerar_entrada_multilinea	/es/docs/Guía_JavaScript_1.5/Trabajar_con_expresiones_regulares/Ejecutar_una_busqueda_global,_discriminar_mayusculas_y_minusculas_y_considerar_entrada_multilínea
/es/docs/Web/JavaScript/Guide/Obsolete_Pages/Guía_JavaScript_1.5/Trabajar_con_expresiones_regulares/Ejemplos_de_expresiones_regulares	/es/docs/Web/JavaScript/Guide/Regular_Expressions
/es/docs/Web/JavaScript/Guide/Obsolete_Pages/Guía_JavaScript_1.5/Trabajar_con_expresiones_regulares/Usar_coincidencias_de_subcadenas_parentizadas	/es/docs/Web/JavaScript/Guide/Regular_Expressions
/es/docs/Web/JavaScript/Guide/Obsolete_Pages/Guía_JavaScript_1.5/Unicode	/en-US/docs/Web/JavaScript/Reference/Lexical_grammar
/es/docs/Web/JavaScript/Guide/Obsolete_Pages/Guía_JavaScript_1.5/Usando_el_objeto_arguments	/es/docs/Web/JavaScript/Guide/Funciones
/es/docs/Web/JavaScript/Guide/Obsolete_Pages/Guía_JavaScript_1.5/Using_the_arguments_object	/es/docs/Web/JavaScript/Guide/Funciones
/es/docs/Web/JavaScript/Guide/Obsolete_Pages/Guía_JavaScript_1.5/Valores	/es/docs/Web/JavaScript/Guide/Grammar_and_types
/es/docs/Web/JavaScript/Guide/Obsolete_Pages/Guía_JavaScript_1.5/Variables	/es/docs/Web/JavaScript/Guide/Grammar_and_types
/es/docs/Web/JavaScript/Guide/Obsolete_Pages/Predefined_Functions	/en-US/docs/Web/JavaScript/Guide/Functions
/es/docs/Web/JavaScript/Guide/Obsolete_Pages/The_Employee_Example	/en-US/docs/Web/JavaScript/Guide/Details_of_the_Object_Model
/es/docs/Web/JavaScript/Guide/Valores,_variables_y_literales	/es/docs/Web/JavaScript/Guide/Grammar_and_types
/es/docs/Web/JavaScript/New_in_JavaScript	/es/docs/Web/JavaScript/Novedades_en_JavaScript
/es/docs/Web/JavaScript/Primeros_Pasos	/es/docs/Learn/Getting_started_with_the_web/JavaScript_basics
/es/docs/Web/JavaScript/Reference/Classes	/es/docs/Web/JavaScript/Referencia/Classes
/es/docs/Web/JavaScript/Reference/Classes/static	/es/docs/Web/JavaScript/Referencia/Classes/static
/es/docs/Web/JavaScript/Reference/Global_Objects/JSON	/es/docs/Web/JavaScript/Referencia/Objetos_globales/JSON
/es/docs/Web/JavaScript/Reference/Global_Objects/JSON/stringify	/es/docs/Web/JavaScript/Referencia/Objetos_globales/JSON/stringify
/es/docs/Web/JavaScript/Reference/Global_Objects/TypedArray	/es/docs/Web/JavaScript/Referencia/Objetos_globales/TypedArray
/es/docs/Web/JavaScript/Reference/Global_Objects/TypedArray/buffer	/es/docs/Web/JavaScript/Referencia/Objetos_globales/TypedArray/buffer
/es/docs/Web/JavaScript/Reference/Global_Objects/TypedArray/subarray	/es/docs/Web/JavaScript/Referencia/Objetos_globales/TypedArray/subarray
/es/docs/Web/JavaScript/Reference/Statements	/es/docs/Web/JavaScript/Referencia/Sentencias
/es/docs/Web/JavaScript/Reference/Statements/const	/es/docs/Web/JavaScript/Referencia/Sentencias/const
/es/docs/Web/JavaScript/Referencia/Características_Despreciadas	/es/docs/Web/JavaScript/Referencia/Características_Desaprobadas
/es/docs/Web/JavaScript/Referencia/Comentarios/comentario	/es/docs/temp_comentarios
/es/docs/Web/JavaScript/Referencia/Funciones/String	/es/docs/Web/JavaScript/Referencia/Objetos_globales/String
/es/docs/Web/JavaScript/Referencia/Funciones_globales	/es/docs/Web/JavaScript/Referencia/Objetos_globales
/es/docs/Web/JavaScript/Referencia/Funciones_globales/Boolean	/es/docs/Web/JavaScript/Referencia/Objetos_globales/Boolean
/es/docs/Web/JavaScript/Referencia/Funciones_globales/Date	/es/docs/Web/JavaScript/Referencia/Objetos_globales/Date
/es/docs/Web/JavaScript/Referencia/Funciones_globales/Object	/es/docs/Web/JavaScript/Referencia/Objetos_globales/Object
/es/docs/Web/JavaScript/Referencia/Funciones_globales/String	/es/docs/Web/JavaScript/Referencia/Objetos_globales/String
/es/docs/Web/JavaScript/Referencia/Funciones_globales/decodeURI	/es/docs/Web/JavaScript/Referencia/Objetos_globales/decodeURI
/es/docs/Web/JavaScript/Referencia/Funciones_globales/decodeURIComponent	/es/docs/Web/JavaScript/Referencia/Objetos_globales/decodeURIComponent
/es/docs/Web/JavaScript/Referencia/Funciones_globales/encodeURI	/es/docs/Web/JavaScript/Referencia/Objetos_globales/encodeURI
/es/docs/Web/JavaScript/Referencia/Funciones_globales/encodeURIComponent	/es/docs/Web/JavaScript/Referencia/Objetos_globales/encodeURIComponent
/es/docs/Web/JavaScript/Referencia/Funciones_globales/isFinite	/es/docs/Web/JavaScript/Referencia/Objetos_globales/isFinite
/es/docs/Web/JavaScript/Referencia/Funciones_globales/isNaN	/es/docs/Web/JavaScript/Referencia/Objetos_globales/isNaN
/es/docs/Web/JavaScript/Referencia/Funciones_globales/parseInt	/es/docs/Web/JavaScript/Referencia/Objetos_globales/parseInt
/es/docs/Web/JavaScript/Referencia/Methods_Index	/es/docs/Web/JavaScript/Referencia
/es/docs/Web/JavaScript/Referencia/Objetos_globales/Array/flatten	/es/docs/Web/JavaScript/Referencia/Objetos_globales/Array/flat
/es/docs/Web/JavaScript/Referencia/Objetos_globales/NumberFormat	/es/docs/Web/JavaScript/Referencia/Objetos_globales/Intl/NumberFormat
/es/docs/Web/JavaScript/Referencia/Objetos_globales/NumberFormat/format	/es/docs/Web/JavaScript/Referencia/Objetos_globales/Intl/NumberFormat/format
/es/docs/Web/JavaScript/Referencia/Objetos_globales/Promesa	/es/docs/Web/JavaScript/Referencia/Objetos_globales/Promise
/es/docs/Web/JavaScript/Referencia/Objetos_globales/Promesa/all	/es/docs/Web/JavaScript/Referencia/Objetos_globales/Promise/all
/es/docs/Web/JavaScript/Referencia/Objetos_globales/Promesa/race	/es/docs/Web/JavaScript/Referencia/Objetos_globales/Promise/race
/es/docs/Web/JavaScript/Referencia/Objetos_globales/String/constructor	/es/docs/Web/JavaScript/Referencia/Objetos_globales/String
/es/docs/Web/JavaScript/Referencia/Objetos_globales/decodeUR	/es/docs/Web/JavaScript/Referencia/Objetos_globales/decodeURI
/es/docs/Web/JavaScript/Referencia/Objetos_globales/isFinite_	/es/docs/Web/JavaScript/Referencia/Objetos_globales/isFinite
/es/docs/Web/JavaScript/Referencia/Objetos_globlales	/es/docs/Web/JavaScript/Referencia/Objetos_globales
/es/docs/Web/JavaScript/Referencia/Operadores/Especiales	/es/docs/Web/JavaScript/Referencia/Operadores
/es/docs/Web/JavaScript/Referencia/Operadores/Especiales/function	/es/docs/Web/JavaScript/Referencia/Operadores/function
/es/docs/Web/JavaScript/Referencia/Operadores/Operadores_especiales	/es/docs/Web/JavaScript/Referencia/Operadores
/es/docs/Web/JavaScript/Referencia/Operadores/Operadores_especiales/Operador_this	/es/docs/Web/JavaScript/Referencia/Operadores/this
/es/docs/Web/JavaScript/Referencia/Operadores/String	/es/docs/Web/JavaScript/Referencia/Operadores/Aritméticos
/es/docs/Web/JavaScript/Referencia/Operadores/get	/es/docs/Web/JavaScript/Referencia/Funciones/get
/es/docs/Web/JavaScript/Referencia/Properties_Index	/es/docs/Web/JavaScript/Referencia
/es/docs/Web/JavaScript/Referencia/Propiedades_globales	/es/docs/Web/JavaScript/Referencia/Objetos_globales
/es/docs/Web/JavaScript/Referencia/Propiedades_globales/Infinity	/es/docs/Web/JavaScript/Referencia/Objetos_globales/Infinity
/es/docs/Web/JavaScript/Referencia/Propiedades_globales/NaN	/es/docs/Web/JavaScript/Referencia/Objetos_globales/NaN
/es/docs/Web/JavaScript/Referencia/Propiedades_globales/undefined	/es/docs/Web/JavaScript/Referencia/Objetos_globales/undefined
/es/docs/Web/JavaScript/Una_nueva_introducción_a_JavaScript	/es/docs/Web/JavaScript/Una_re-introducción_a_JavaScript
/es/docs/Web/Reference/Events	/es/docs/Web/Events
/es/docs/Web/Reference/Events/DOMContentLoaded	/es/docs/Web/Events/DOMContentLoaded
/es/docs/Web/Reference/Events/DOMSubtreeModified	/es/docs/Web/Events/DOMSubtreeModified
/es/docs/Web/Reference/Events/abort	/es/docs/Web/Events/abort
/es/docs/Web/Reference/Events/animationend	/es/docs/Web/Events/animationend
/es/docs/Web/Reference/Events/beforeunload	/es/docs/Web/Events/beforeunload
/es/docs/Web/Reference/Events/blur	/es/docs/Web/Events/blur
/es/docs/Web/Reference/Events/canplay	/es/docs/Web/API/HTMLMediaElement/canplay_event
/es/docs/Web/Reference/Events/click	/es/docs/Web/API/Element/click_event
/es/docs/Web/Reference/Events/close_websocket	/es/docs/Web/API/WebSocket/close_event
/es/docs/Web/Reference/Events/dragover	/es/docs/Web/API/Document/dragover_event
/es/docs/Web/Reference/Events/hashchange	/es/docs/Web/API/Window/hashchange_event
/es/docs/Web/Reference/Events/keydown	/es/docs/Web/API/Document/keydown_event
/es/docs/Web/Reference/Events/load	/es/docs/Web/Events/load
/es/docs/Web/Reference/Events/loadend	/es/docs/Web/Events/loadend
/es/docs/Web/Reference/Events/mousedown	/es/docs/Web/API/Element/mousedown_event
/es/docs/Web/Reference/Events/pointerlockchange	/es/docs/Web/Events/pointerlockchange
/es/docs/Web/Reference/Events/scroll	/es/docs/Web/API/Document/scroll_event
/es/docs/Web/Reference/Events/tecla	/es/docs/Web/API/Document/keyup_event
/es/docs/Web/Reference/Events/timeupdate	/es/docs/Web/API/HTMLMediaElement/timeupdate_event
/es/docs/Web/Reference/Events/transitioncancel	/es/docs/Web/Events/transitioncancel
/es/docs/Web/Reference/Events/transitionend	/es/docs/Web/Events/transitionend
/es/docs/Web/Reference/Events/wheel	/es/docs/Web/API/Element/wheel_event
/es/docs/Web/WebGL	/es/docs/Web/API/WebGL_API
/es/docs/Web/WebGL/Animating_objects_with_WebGL	/es/docs/Web/API/WebGL_API/Tutorial/Animating_objects_with_WebGL
/es/docs/Web/WebGL/Getting_started_with_WebGL	/es/docs/Web/API/WebGL_API/Tutorial/Getting_started_with_WebGL
/es/docs/Web/XSLT/Elementos	/es/docs/Web/XSLT/Element
/es/docs/Web/XSLT/Elementos/element	/es/docs/Web/XSLT/Element/element
/es/docs/WebGL	/es/docs/Web/API/WebGL_API
/es/docs/WebGL/Animating_objects_with_WebGL	/es/docs/Web/API/WebGL_API/Tutorial/Animating_objects_with_WebGL
/es/docs/WebSockets-840092-dup	/es/docs/Web/API/WebSockets_API
/es/docs/WebSockets-840092-dup/Escribiendo_servidor_WebSocket	/es/docs/Web/API/WebSockets_API/Escribiendo_servidor_WebSocket
/es/docs/WebSockets-840092-dup/Escribiendo_servidores_con_WebSocket	/es/docs/Web/API/WebSockets_API/Escribiendo_servidores_con_WebSocket
/es/docs/WebSockets-840092-dup/Writing_WebSocket_client_applications	/es/docs/Web/API/WebSockets_API/Writing_WebSocket_client_applications
/es/docs/Windows_8	/es/docs/Mozilla/Developer_guide/Documentación_para_la_compilación/Windows_8
/es/docs/XForms:Comunidad	/es/docs/XForms/Comunidad
/es/docs/XForms:Soporte_en_Mozilla	/es/docs/XForms/Soporte_en_Mozilla
/es/docs/XML:Comunidad	/es/docs/XML/Comunidad
/es/docs/XMLHttpRequest	/es/docs/Web/API/XMLHttpRequest
/es/docs/XMLHttpRequest/FormData	/es/docs/Web/API/XMLHttpRequest/FormData
/es/docs/XMLHttpRequest/Using_XMLHttpRequest	/es/docs/Web/API/XMLHttpRequest/Using_XMLHttpRequest
/es/docs/XMLHttpRequest/abort	/es/docs/Web/API/XMLHttpRequest/abort
/es/docs/XMLHttpRequest/onreadystatechange	/es/docs/Web/API/XMLHttpRequest/onreadystatechange
/es/docs/XPath	/es/docs/Web/XPath
/es/docs/XPath/Ejes	/es/docs/Web/XPath/Ejes
/es/docs/XPath/Ejes/ancestor	/es/docs/Web/XPath/Ejes/ancestor
/es/docs/XPath/Ejes/ancestor-or-self	/es/docs/Web/XPath/Ejes/ancestor-or-self
/es/docs/XPath/Ejes/attribute	/es/docs/Web/XPath/Ejes/attribute
/es/docs/XPath/Ejes/child	/es/docs/Web/XPath/Ejes/child
/es/docs/XPath/Ejes/descendant	/es/docs/Web/XPath/Ejes/descendant
/es/docs/XPath/Ejes/descendant-or-self	/es/docs/Web/XPath/Ejes/descendant-or-self
/es/docs/XPath/Ejes/following	/es/docs/Web/XPath/Ejes/following
/es/docs/XPath/Ejes/following-sibling	/es/docs/Web/XPath/Ejes/following-sibling
/es/docs/XPath/Ejes/namespace	/es/docs/Web/XPath/Ejes/namespace
/es/docs/XPath/Ejes/parent	/es/docs/Web/XPath/Ejes/parent
/es/docs/XPath/Ejes/preceding	/es/docs/Web/XPath/Ejes/preceding
/es/docs/XPath/Ejes/preceding-sibling	/es/docs/Web/XPath/Ejes/preceding-sibling
/es/docs/XPath/Ejes/self	/es/docs/Web/XPath/Ejes/self
/es/docs/XPath/Funciones	/es/docs/Web/XPath/Funciones
/es/docs/XPath/Funciones-XPath/true	/es/docs/Web/XPath/Funciones/true
/es/docs/XPath/Funciones/contains	/es/docs/Web/XPath/Funciones/contains
/es/docs/XPath/Funciones/substring	/es/docs/Web/XPath/Funciones/substring
/es/docs/XPath/Funciones/true	/es/docs/Web/XPath/Funciones/true
/es/docs/XPath/funciones-xpath	/es/docs/Web/XPath/Funciones
/es/docs/XPath/funciones-xpath/contains	/es/docs/Web/XPath/Funciones/contains
/es/docs/XPath/funciones-xpath/substring	/es/docs/Web/XPath/Funciones/substring
/es/docs/XPath:Ejes	/es/docs/Web/XPath/Ejes
/es/docs/XPath:Ejes:ancestor	/es/docs/Web/XPath/Ejes/ancestor
/es/docs/XPath:Ejes:ancestor-or-self	/es/docs/Web/XPath/Ejes/ancestor-or-self
/es/docs/XPath:Ejes:attribute	/es/docs/Web/XPath/Ejes/attribute
/es/docs/XPath:Ejes:child	/es/docs/Web/XPath/Ejes/child
/es/docs/XPath:Ejes:descendant	/es/docs/Web/XPath/Ejes/descendant
/es/docs/XPath:Ejes:descendant-or-self	/es/docs/Web/XPath/Ejes/descendant-or-self
/es/docs/XPath:Ejes:following	/es/docs/Web/XPath/Ejes/following
/es/docs/XPath:Ejes:following-sibling	/es/docs/Web/XPath/Ejes/following-sibling
/es/docs/XPath:Ejes:namespace	/es/docs/Web/XPath/Ejes/namespace
/es/docs/XPath:Ejes:parent	/es/docs/Web/XPath/Ejes/parent
/es/docs/XPath:Ejes:preceding	/es/docs/Web/XPath/Ejes/preceding
/es/docs/XPath:Ejes:preceding-sibling	/es/docs/Web/XPath/Ejes/preceding-sibling
/es/docs/XPath:Ejes:self	/es/docs/Web/XPath/Ejes/self
/es/docs/XPath:Funciones:contains	/es/docs/Web/XPath/Funciones/contains
/es/docs/XPath:Funciones:substring	/es/docs/Web/XPath/Funciones/substring
/es/docs/XPath:Funciones:true	/es/docs/Web/XPath/Funciones/true
/es/docs/XSLT	/es/docs/Web/XSLT
/es/docs/XSLT/Elementos	/es/docs/Web/XSLT/Element
/es/docs/XSLT/apply-imports	/es/docs/Web/XSLT/apply-imports
/es/docs/XSLT/apply-templates	/es/docs/Web/XSLT/apply-templates
/es/docs/XSLT/attribute	/es/docs/Web/XSLT/attribute
/es/docs/XSLT/attribute-set	/es/docs/Web/XSLT/attribute-set
/es/docs/XSLT/call-template	/es/docs/Web/XSLT/call-template
/es/docs/XSLT/choose	/es/docs/Web/XSLT/choose
/es/docs/XSLT/comment	/es/docs/Web/XSLT/comment
/es/docs/XSLT/copy	/es/docs/Web/XSLT/copy
/es/docs/XSLT/copy-of	/es/docs/Web/XSLT/copy-of
/es/docs/XSLT/decimal-format	/es/docs/Web/XSLT/decimal-format
/es/docs/XSLT/element	/es/docs/Web/XSLT/Element/element
/es/docs/XSLT/fallback	/es/docs/Web/XSLT/fallback
/es/docs/XSLT/for-each	/es/docs/Web/XSLT/for-each
/es/docs/XSLT/if	/es/docs/Web/XSLT/if
/es/docs/XSLT/import	/es/docs/Web/XSLT/import
/es/docs/XSLT/include	/es/docs/Web/XSLT/include
/es/docs/XSLT/key	/es/docs/Web/XSLT/key
/es/docs/XSLT/message	/es/docs/Web/XSLT/message
/es/docs/XSLT/namespace-alias	/es/docs/Web/XSLT/namespace-alias
/es/docs/XSLT/number	/es/docs/Web/XSLT/number
/es/docs/XSLT/otherwise	/es/docs/Web/XSLT/otherwise
/es/docs/XSLT/when	/es/docs/Web/XSLT/when
/es/docs/XSLT/with-param	/es/docs/Web/XSLT/with-param
/es/docs/XSLT:Elementos	/es/docs/Web/XSLT/Element
/es/docs/XSLT:apply-imports	/es/docs/Web/XSLT/apply-imports
/es/docs/XSLT:apply-templates	/es/docs/Web/XSLT/apply-templates
/es/docs/XSLT:attribute	/es/docs/Web/XSLT/attribute
/es/docs/XSLT:attribute-set	/es/docs/Web/XSLT/attribute-set
/es/docs/XSLT:call-template	/es/docs/Web/XSLT/call-template
/es/docs/XSLT:choose	/es/docs/Web/XSLT/choose
/es/docs/XSLT:comment	/es/docs/Web/XSLT/comment
/es/docs/XSLT:copy	/es/docs/Web/XSLT/copy
/es/docs/XSLT:copy-of	/es/docs/Web/XSLT/copy-of
/es/docs/XSLT:decimal-format	/es/docs/Web/XSLT/decimal-format
/es/docs/XSLT:element	/es/docs/Web/XSLT/Element/element
/es/docs/XSLT:fallback	/es/docs/Web/XSLT/fallback
/es/docs/XSLT:for-each	/es/docs/Web/XSLT/for-each
/es/docs/XSLT:if	/es/docs/Web/XSLT/if
/es/docs/XSLT:import	/es/docs/Web/XSLT/import
/es/docs/XSLT:include	/es/docs/Web/XSLT/include
/es/docs/XSLT:key	/es/docs/Web/XSLT/key
/es/docs/XSLT:message	/es/docs/Web/XSLT/message
/es/docs/XSLT:namespace-alias	/es/docs/Web/XSLT/namespace-alias
/es/docs/XSLT:number	/es/docs/Web/XSLT/number
/es/docs/XSLT:otherwise	/es/docs/Web/XSLT/otherwise
/es/docs/XSLT:when	/es/docs/Web/XSLT/when
/es/docs/XSLT:with-param	/es/docs/Web/XSLT/with-param
/es/docs/controladores_protocolos_web	/es/docs/Web/API/Navigator/registerProtocolHandler/Web-based_protocol_handlers
/es/docs/en	/en-US/
/es/docs/firefox_Web_Developer_(externo)	https://addons.mozilla.org/firefox/60/
/es/docs/lugares	/es/docs/Catálogo
/es/docs/mozilla-central	/es/docs/Mozilla/Developer_guide/mozilla-central
/es/docs/nsISupports:AddRef	/es/docs/nsISupports/AddRef
/es/docs/nsISupports:QueryInterface	/es/docs/nsISupports/QueryInterface
/es/docs/nsISupports:Release	/es/docs/nsISupports/Release
/es/docs/video	/es/docs/Web/HTML/Elemento/video
